  #              ##   #       #         #   #     
                      #              ##    #      
#     ##       ##   #          #                  
         ##      # ###    ## #     #          #   
  #  #  #               #         #              #
 #     #       #     # #      ##    ##          # 
#        #  #  #    # #  # #                      
         #    # #                                 
  #                     #    #  ## #              
  #                          #              # #   
 #            ##    #  #                          
                               #    #  #     ## # 
        #  #        #    #  #                     
       # #         #   #       #  #               
    #  #                      #     #   ####      
           #  #               ##          #     ##
      #       #           #       #        #     #
    #                        #  #                 
  #    #    #   # # #           #  #   ##  #  #   
        #    #   #                        #   #  #
#  ##          #          #         #   #    ##   
          ##    #       #                         
  #      #      #     ##               #  #       
   #               #     #                        
  #       #         #            # #              
                      #     # #         #        #
#           #        #        # #     #         # 
                         #       #                
# #     #                #      #         #  #    
#    #                                      #     
         # # #  # #     #   # # #                 
 #   ###            # #      #  #               # 
#      #     #             #         #  #         
 # #    #                  #                      
          #     #  ###  #       #      ##         
                    #  #     #    #     #         
                #              ######             
                    #             #               
  #     #          #                ##         #  
                         #  # # #               ##
#   #       #  #       #              #     #   # 
    #  #  #  #  ##    #  #     #     #      #    #
#    # ##        #     #                   #  #   
 ##            #   #     ##  ## ##  ##     # #    
    #       ###   #   ## #   #            #  #   #
   #         #   # #    ##    #     ##        ##  
                  #       #     #    #            
      # #  #      #   # # #    # # ##     #       
    #         ##          #     #          #     #
     #             #  #     #  #          # #     
