 #    #    #          #        #  #   ##       #  
 #      #   #         #  #            #           
                      #  ##  #                    
#                #       #   #   ##    #  #  #    
     ###             #        #           ##      
        #           #      #   #    #      ##     
                 #       ## #     #      #     #  
  ##       #       #  #   # #       # #      #    
           #       #     # ##    ###              
     #        # #     ##  #        #    #      ## 
   #              #   #   #         #             
#          #        #       #       #   #        #
          #             # #   #    #    #         
     #    #           #  #            # #   #  #  
         #        #     #   #            #  #     
   #     #        #       #  #        ##          
                  #         #     ##      #   #   
##      #         #           #          #    #   
               #    # #                           
      #              #  #      #             #    
  #            #      #   #            #   #  ### 
                #        #    #        #   # #    
#         #           #  #          ##    #    #  
            #    # ##              #        # #   
  #                              #                
  #                  #       #     #              
         ##       # #   #                         
# #              #                         #      
          #                                      #
  #  #                                            
               # #        ##     #       #        
 #   # # #     # #     #  #      ##        #      
         #       #           #    ## #  #         
                   #      #   # #  ##     #   # # 
 #       #          #  #      #                   
     # ###      ###      #           #            
 #  #        #          #  # #  #                 
 # # #     ###    #   #   ##  #              #    
         # ###            #     # #      #   #   #
 #     ## # #            # #     #     #      ##  
                    #   # # #   #         #  #    
# #  # #  # #  #           #     ###  # #         
  #   #    #  #                                 # 
    # #     # #       #        #           #      
 #   # #               #    # #     #             
          ##     #           #             ##     
                                           #      
#  #               #       #          #          #
     #    # ##      ##          #   #    # #      
            #                      #         # #  
