     ## ## #                  #   # #    #        
       #    #            #         #          #   
 #         #  #           #      #        ##   #  
           #        #     #   #    #   #          
         # #          #    #   ##               # 
#         #                #     #  #             
#   #  #         #       #   #    #    #      #   
   #  #   #  #            #  #  #     #           
   #    #   #  # #  #   ##      # #     #         
    #      #   #            # #               # ##
 #               #       #      #                 
 ##            #    #            #             #  
  ##                 #   # #       #              
     #         ##    #               #     #    # 
              # #                  #   #          
        #      #              #   #            #  
           #        #  #                #         
                                           # #    
         ##     #  ###     #    ##              # 
          ##       # #                          # 
     #     # ##  #  #       #      #              
#        ## ##         #        #   # # #       ##
  #     #                   # #  # #    # #    #  
     #    #       #  #       # #     #    #  #  ##
#                           #     ## #           #
     #              #   #                         
      #           #  #   #  #                     
               #        ##  #                     
     #         #      # ##         #              
        #           #    ##                       
    #                ##  ###   #                 #
     ####   #            #         #            # 
                 #                                
               #   #     # #       #      #       
    #         #       #   #   #                 # 
#  ##   #                       #          # #    
    # #  #       # #  #     #          #  #    #  
     #            #     #  #                      
            #         #    #        #       #     
               #    # ##     #  #        #   #    
       # ##    #      # #   #     #  #            
         # # #    #                               
      #            ##       #                    #
   #           #  #    #        #   #             
      #  #      #        ##  # #     #           #
  # # #      ##   # #     #       # ##            
        #  #         #      #                     
    #            #      #     #          #        
       #       #   #        #     #    ####    #  
                #     #        #                  
