                    #  ##      #  #        #      
   #    #            #    #      #           #    
        #   #    #              #   #         #   
              # #      ####       #    #    #   # 
        #    ###       #           #           #  
   # #       #   #         #               ## ##  
                #      #        #   # #           
              #     #     #              ##   ### 
  #        #               ##               ##    
    ##    #       ##   ##     #                   
#       #       #                # #      ##      
             #  #             #     #   #  ## #   
          #        ##   ##           #    ##     #
#     #               # ###  ##            # #    
    ##    #   #    ###      # #   #               
        #        # #                  #    #      
#### #     #  #    #   #                 #    ##  
        #          #           #                  
                      #       # #                 
 #      ##                         #    #   #     
     #  #   #  #     # ## #    #               # #
          #    #                 #      ##        
#    #    # #          #    #                     
#  #                   #       # #       #   #  # 
  #   #    #  ##    #                #            
                      #       #                   
         #  ## #  # #           #             #   
    # #           # #   #                  #      
#                   #              #        #     
                    #    #                  #     
   #  #  #                              #       # 
   #         #    # #              #           #  
  # #         #    #     # ###  #        ###  #   
 #     #              #   #                ##    #
        #          #      ##  #  # # #    #    ## 
  #    #  ##       #       #      # #    #        
      #  #         #       #       #  ##          
  #            #    #           #   #       #   # 
#                           #     #  #        #  #
             #                   # ##          #  
               ##      #                       #  
         #      ##  #   #   #                     
  #    ##          #      #            # #       #
 #      #      # #  #    #           ##       #   
  #      #  #  # #  #    ##         #        #    
       #  #                   #      #            
 #   #       #  #   #               #      #    # 
              #    # #       #                    
      #             #  #              # #         
  #            #       #            #       #     
