                     #     #  #        #  #       
 #             #        #            # #    #     
                #   #   #        # #              
                #             #  ##       #       
 #           #   #        #    #  #       #     ##
    # #             #                           # 
        #      #               #               #  
#  #    #           #  #    #              ##    #
 #  #     # #   #    #   #        #       #       
      #  ##       #    #    #          #  #   #   
#         #           #  #        #  #   #    #   
       #  #  #        # #  #                #    #
      #    # #        #  #       ##  #            
  #        #  #   # #    # #  # #                 
                   #       #    #     #       #   
 ##           #   #     # #       # ##  #         
#         # #  # ##     # #  # #                  
             #   #      #                        #
     #          #        #         #   #  # #     
     #                      #               #     
           ##      #  #  # # ### #   #   #     #  
    #   #                           #             
  #    #   #      #         #      ##             
 #             ##           #         ##    ##    
  #         #               #                  #  
                        #    #                    
                    #                   #         
      #             #                             
            #    #  #     #     #            #    
    #     #           # #                         
  ##     #  #   # #  # #       #         #   #    
       #  #                ##   #   # #      #    
  #       #   # #       #      #                 #
# #         #              #    #          ##     
 #   #  ###   #    ##     #      # #           #  
  #       #                #       #      #    #  
##                            #    #    #         
         #     #  #                     ##  #     
   # #                    ###              #      
 #      #  # #       #            #  #       ##   
                        #       #    #  #   # #  #
  #  ## #    #    #        #            # #       
    #     #     #  #   #    #     #    ###     #  
 # #    #  #                 #        #   #       
  #  #               #                     # # #  
##                       #       #          #     
   # #       ##        #  # ##    #         #     
            ##      #                        #    
            #        #   ##  #     #    #         
        #         #     #      #           ##  #  
