   #  # ###         #                     # ##    
 # #    #                  # ###    #      #      
    #   #   #   #                                 
#      #                   #          #  #       #
  #    #    #       #   #     # #            ##   
          #                    #  #     #     #  #
      #    ##  # #   #      ##     #       # #   #
     ##     #      ##          #          #  #    
      #    # #        #  # ## #            #    # 
#               # #  #     #        #  #      #  #
              #          #   #                    
   # #    # #    #        #                       
                #  #         #             #      
              # #            #  #     # #   # #   
  # #  ##          #               #   #   #      
     #  #  ##     #    #    #  #  ##           #  
  #  # ##           #   #           #          # #
#  #  #          #      # #  #           #      # 
                  #  #     #        #             
#      #                             #           #
    #     # ##                 # #  #         #   
#      ## #      ##  # #       #   #              
       # #  #    #       #      #       #  ##     
#              #   #           #                  
                ##          #   #                 
      #                                           
 #      ###  #               #                    
      #      #      #                #            
                      #       #         #  ###    
                         #                #      #
#             ##   # ##          #    #   #  #    
# ## ##          ##                #              
    #                #  ### ##    #  #   ##  #    
   ###                   #   # #     # #         #
    #               #  #     #         #          
 #     ## #     #          # #       #  # ### #   
   ## #       # #                #  #  #   ###   #
       #     #  #   #      #                #  #  
  # #    #        #  ###  # #     #               
      #           #    #              ##   # #    
     #       #        #                  ##     # 
   #   #   #                          #           
               #            #             ##    # 
           #                              #   ##  
   # #                  #              ##    #    
 #                      #       #          #     #
#  #        #         #  #     #            #     
 #       #                  # #   #  #         #  
             #    #                       #  #    
      #  #   #      ##   #       ##         #     
