          #           #    #    #       #  #     #
         #        #     #    # #           #      
          # #    #                      #   ##    
    # #  ##       # #               #   #      #  
 #               #      #                #   # #  
     ##      #     #     #       #       #    #  #
##  ##         #                       #       #  
     #       ##    #    #   #  # #  #     #     # 
#     #                # #  #  ##  # #     #    ##
  #   ##           #     #    ## #       ##    # #
      #   ###          #   ##   #                 
# #        #   ##          #                  ##  
      # #      #   #              #    #          
               #     #    #             #         
   #          #   #                # #  ##        
           # # #                                  
  ##                 ##  #       ##               
 #       #  #             #          #           #
   #         #        #        # #             #  
   ##                    # #         # #     #    
                #                           #    #
                    # #  #  #    ##     #         
          #    #      #    #  #     #        ##   
#      #    #  #   #   #       #   ###     #      
 #                          #                     
                                                  
                 #           #        # #       ##
 #                   #   #   #                    
#        #  #        #        #  #        #    #  
    #               #         #                   
  # #   #  #                           #  #       
                     #         ## #       #       
       #             #   #      #                 
 #   # #  #    #      # #            #            
#    #                          # ##             #
       #       # #          #   #     #    #      
 #   #      #    # # #       #      #  ##  #      
         #   #                      #        #    
    #          #  #    #    ##         ##       # 
          ##     #  #          #     #            
   ##           #             #    #      #       
               #         ##                       
 ##    ###    #                 #          #  #   
              # #   #         #       #         ##
#      #     # #              #      #           #
   ##   #    #                 ##   #     #   # # 
 ##    #                        #           #     
 ## #  #   #       #   #  #           #    ###    
  #    #    #       #    # #           # #        
#       ## ##     #     ##         #          #   
