  #      #    #   #              #         #      
   ##                #             #     #     ## 
     # #  #     #        #   ## #       #         
               #      # #    #             #      
     #   #      #  #  #  #  #                     
         #           ##            #     #  #     
  #                       #              #        
  #    #        #                  # #         ## 
# #    #    #           #                     #  #
 # #     #           #  ###              #  #     
  #  #          #    # # #  #            #        
    #     ##        # #   ## #       #       ##   
       #                    ##    #             # 
# # # #    #    #          #          #  #    # # 
  #  ##                    ##     ##   #  #      #
 #      #                    #    ##       #      
              #   #              #        #      #
                  #          #     #   #  #       
#   #           #   ##                            
              ##      ##   #           #    # #   
           #    ##                       #    #   
         #                    #   #          #    
      #                   ##   #        #  # #    
 ##   #    #     #      #     #              ## ##
# #    ##      ##             #     #         #   
          #         #     # # #                   
            #     #       #  #                   #
 #      #    #      #    #            #    #      
  #                          #  #    #            
#   #               #                             
 #                                   #      #     
      #     #        #  ## #        #      ##     
      ##   ##    # #                            # 
 ###       #  #              #       #            
  #  #  #                #                        
      #    #                            #   #     
               #                #                 
        #            #  ##   #                    
#        # #                                      
              #     #  #                          
                  ###  #  #     ##                
#           #    # ##  #       #         # # #  # 
           #   #       #        #    #            
         #  #              ##                     
 #   #       #  #          # #    #        #      
   #        #       #             # #         #   
 ##    #                #          #        #     
   #            #          #           ##       # 
        #      #    #         ##   #     #        
            #                  ##                 
