   ##               # ## ###   #   #      # #     
        #      #                #      #      #   
       #                       #                  
  # #               #    #      # #            #  
   #  # #               #                        #
  # #        ##                  #    #          #
          #         #     #        #          #  #
  #      #            #  #              #        #
       ##       #   #                  #       #  
                    #       #        ##   #       
 #   #          #     ###    ##    #         # #  
                                          #  ##   
          #      # #            ##                
     #         #                 # #      #       
     #        #  ##     #   # #   #               
#           #        #           #         #      
    # #      #         ####         #     #    #  
    #           ##     # #     ###    # #      #  
  #   #  #    ## # #      #     #     #   #       
  #     #     # #          #            #         
              #              #     #  #      #  # 
         #      #    #              #         #   
   #  #  # # #        ##       ##       #    #   #
   #                    #      #          # #     
           #                                #     
  #                  #                            
                    #        #          #         
                          #        #              
                                          #  #    
    #                    #                  #     
     #        # #           #     #   #  #    ### 
 ## #       #     ##        # #    #              
            # # # #                               
  #  #                            #  # #     #    
  #      # #              # #       #    ##     # 
   #   ##   #   #  #      #             #     #   
## ##   # ### #           ##  #      #  ##  #  ## 
             ##   #      ##    # ###      #     # 
##    # #            #     #    #                 
         #                                # ##    
   #   #  #  #  #             ## #               #
                     #  #       #  #  #         # 
             #         # #  #           #         
      ##  #  #         #    #      #   #         #
      #          #   #        ##               #  
     #   #     #      #      #          # # #     
 #  #     # #        #             #   #  #   ##  
  #                   ##           #           #  
##    ##    # #   ##      #        #            # 
           #   ## #  # # # #  #            #      
