      #    #  #  #        #    #              #   
     #            #         ##    #  #   #       #
   #        ##   ### #                 #          
#                               #                 
 ##     # #        #        #    #    #      #    
           #   ##               ##             #  
                                   ##   #   ##  # 
       ##      #    #  #   ## #           #      #
    #                  #  #            #      #   
#           #              ##                     
  #    #         #               #      # #       
                #              #    #  #  ##    # 
                # #            #            #     
   # ##     #  #  #              #  #      #      
      #   #   #                                   
           #          #      ##   # #     #      #
#    ##        # ##  #  #            #            
                     #          ##  # #       #   
           ##  #   #          #                  #
      # #  # #        # #  #                 #    
      #    #     #                  #      #      
  #         #                                     
#                    # #          #     # #      #
        #           #                 ##      # # 
#        ##   #              #      #       #     
#                   #   # #                       
             # #            #                     
        #                       #     #           
  #  #           #           #                    
                     #  #                 #       
          #   #        #                         #
     #        #       #               #    ##  #  
 #          ##     #       #              #       
    #    #         #          #      ##    #      
                  #   #           #     #   #     
 #   #     #  #  #     #     #            #       
  #        #   ##     ##       # #            ##  
  ###  ##    #       #   # #          #   #       
 #    ##     # #         #                #    #  
  #  #       #     #           #   # ##           
     #         #            #  #                  
   #    ##  #    #               #        # ##    
  ##  #  #        ## #                   #  #     
     #   #           #                       ##   
        #    # #  #     #      # #   #            
##   #                      #   #   #  #          
##        #       #      #                        
 # #                     #                #    # #
#  #    #    # #     #                            
#             ##            #                     
