        # #  #  #                           # #   
  #         #           ##               ###      
            # #       ####            #      #    
 #                             ## #              #
            ##    #      #    #    #              
 #       #      #    ##    # #          ##   #  # 
 #            #     #           #    #   # #      
##     #   # #             #  # #    #            
        #  # #     ## #             #  #  #       
                       #   # #  #              #  
    ###          #  #         #           #       
 # #           #             #  #    #        #   
##   #   #      #     #       #       ##      #   
                 #        #         #    #      # 
                    #       #  #                  
        # ###       # # # #     #        ##   ##  
   #                 #        #  #         #      
 #   #  ##           #           #     #          
                   #         #       # #          
           #  #  #        #     ##    #        #  
# #              #      #  ## #      #   #   ##   
#      #    #  #           #                      
#  #      # # #    #        #   #     # #         
      #     #   #         #    #           #      
                   #                #   #         
                                                  
      #          #        # #    #      #       # 
         #                                        
                             #  #  # #  #  #      
  # #          #         #         #              
          #  #  #             ##       # #     #  
 #    #             #  ## #           #          #
    #         #   #       #                     # 
#   #       #  #          #      # #     #        
  #   #    #           #            #         #   
     #             ## #  #    #             #     
                          # ##       #            
#                       #       #   # ###      #  
  #  #             # # #         #            #   
##        #    #          #    #                  
                      #  #  #           #      #  
  #  #       #               #  #  #  #  #        
 #   #  # # #         ## #         #              
    #       # # # #                   ##  #    #  
      #  #  ##       #               #  #    #   #
 #  # #       #           #  ##            #      
#  #    # ##              # #         #      # #  
                                #            #   #
        # ###  # #    #                  #       #
                        #      #      #         # 
