  #     #  ##     ##        #                     
#                #                        # ###   
              # #            ##       #           
 #   # #    #        #  #               #         
                #    ##            #    # # #  # #
    #  ###   #  # #            #                  
##   #   #                           #  #   #     
 ##   #      # # #           #      #          #  
      #   #         #  #          #          #    
         #        #  #                            
               #               #    #            #
 #        #       #    #         #   #            
  ## #              # # #     #  # #              
       #         #      #       ##                
     #                #                 ## #      
  #          # #       #  #      #                
#  #   # #     #         #   # #                  
   #             # #        # #          #        
   # ##     #  ##  #  #        #    #             
              #                  #    #     ##    
  #        #                  #         ##        
 #         #    #          ##          #      ##  
        #     ###     #   ##    #     #          #
  ####      ##    ##    # ##    # #  #        # # 
           #  #  # ##          #        #   #  #  
    #                       #               #     
         #     #    #   #        # #          #   
      #     #       #    #           #            
 #  #                    #  #              #  #   
                                   #    #         
              # # #        #                  ##  
           #           #          #        #      
          #       #         ##   #                
              #  #           #       ##           
   #  #    ####   #                  # #  #       
    #        #  #   #   #           #         #   
#       #      #     ###      # # ##              
#  #### #               #     #      #            
#       #                       #  ##             
 #               #         #   #                # 
    #  #            #     # #   #              ## 
 #   ##    ##       #                 #   #       
     #    #     #  ##         #     #             
          #     ##       #  #   #             #   
        #              # #        # # ##    # # # 
#   #   # #     #   #                     #   #   
  ##       #           #             #            
     ####   #           # #    #  #             # 
        ##       # #         #   #                
            # #     ## ##     #                #  
