           ##    #             #             ##  #
#       #  ## #             #              #      
        #  #  #     #     #                  #    
    #            ## #      #      #        # #    
 #   #      #           # ##                  #   
       #   ##         #     #         ###      #  
     ##     #     #                               
#    #  #       #                 #               
 ##      #   ##       ##         #  #       #   # 
             #                        #      ##   
          #     #    #                            
                 #       #                        
              # ####                      ##      
   #   #        #              ##  #     #  #   # 
#      #  # #                 #   #      #     #  
#                       #     #     #   ##   #    
                #  #  #       ##         #  #     
  #  #   ##    #                     #       # #  
 #  # #       ##          #                    # #
           #                         #          # 
#                     #    # #  ##         #      
  #      # #       #          #        #         #
 #   #  # #                #                   #  
    #    ##               #      #          #     
       #  #  #      #             ##             #
                              #                   
        #            ##          #          #  #  
        #                 # #             #       
         ##       #                               
         #            #                     #     
###    ##          #        #         # #    #    
 #  ##            #                 #            #
         # #   #       # #            #          #
                #       ###    #    # ##    #   # 
#              #           ##       ###        #  
                             #      #   # ## #    
        #  #   #    ## ##    #           #        
     #   #    #   ##     ##    #      #  #        
          # #           #               #         
           ##        #      ##    #    #          
   #         ##           #      # ##           # 
 ##           #  #  #      #        #    #        
      #   ##       ##      # ##     ##     # #    
   #         #            ##   #                 #
 #    #   #          #   #                    #   
       #  ##      #           #         # #  #    
   ##    #  #               #                     
# #  ##               #    #      #    #          
     #      #    #    #               #  #        
  #               # #         # #      #  #       
