       #    #    #  ##  #      # #           # #  
    #  #    #  ## #     #  #    ##    #         # 
      #      #       #     #  ##          #    #  
           #          ##  #       #     #         
 #       #  #           #                 #       
 #       #           #          #    #         ## 
 #                  #          ##     #           
       # ##   #    #    #    #    #   #          #
### #   #   ##  #       #       #  #     # #      
      #                   #      ##        #      
       ##            #   # #        #     ###     
       #    #      #    #      #  ##              
     #    #           # #           ##         #  
     #  #     #  #          ## ##          # #    
  #                #                  #        #  
#  ##  #           #            #   # #        #  
 #    #           #                           #   
     #  #                 # # #           #   ##  
              #       # #               #         
                      #   #           #  #   ##  #
 #         #             #      #     #           
     #      ###  #   #    #                       
      #     #                   #   #             
  #        #     #                           #    
 #              # #                    #          
               #                            #     
         ##  #      # #          #             ## 
            ## #             #            #       
 #                  ##               #     ###    
                         ##   #                  #
   ###         #                 #      #     #   
 #         # # ###       #       #      #   #     
    #    #    #           #  ###     # #   #      
            #   #   # #            #             #
   #                 #      ## #    # #           
   ##     ##            #  #  #   #               
     #   #   #    #    #       #         # #      
    #    #    #    #   #   #            #     #   
#   # # #   #               ##              ##    
         ##     #    ##         ##  #     ##      
##        # #  #       #      #          #        
   # #             #       #  #                   
        #                ## #      #              
  #      #      #                     #  #    #  #
#  #  #        ###      #      # ##      #        
 #   # #                ##    #       # #    #    
  #  #       #   #                ## # #          
   #     #      #  # #             #     # #     #
      #            #               #  #        #  
     #         #      ## ## ##        #           
