  #      #              #            # #   #      
#  #   #   #  #   #  # #   #    #     #    #      
       #  #    #              #     #   #   #     
      #     # #  #                           #  # 
            ##       ##       # #     #          #
  #    #    #     #    ## ##           #    #     
          #     #        #   #  # #     #        #
    ##               #     #   #   #        #    #
#      ##      #                          #   #   
    #                  # #  #    #               #
                      #       #                   
               #                  ##    #  ## #   
 ##         ##         #            #        #    
#                #   #          #       #     #   
     #      #       #                ##          #
   #  #       #   #               #   #   #       
            #    # #    # #                    #  
 #   #      #  ##             #      ## #  ## # ##
##  #            #               # #        #    #
#    #           #  #               ## #          
        #   ##  #        #  #     #       #  #    
    #                   #  #     #              # 
         #       #      #       ##        #    ## 
                      #            #            ##
                               # ###    #         
 #                   #       #          #         
 ##          #      #        #          #       ##
         ##                  #     #      #       
                    # # #   #        #     #  ##  
 #    #   #               #                       
  #        #               #   #   #    #         
    #        #   #  #        #   #       ##       
          # #   ###        # # #       #  #     ##
 #    #     #   #      #  #         # # #         
     # #    #   ##                               #
   #             #   #  #                         
  #                               #               
              # #         #                   #   
     #          ##  #       #   #       # #    #  
   #             ##  #   # ##                     
               ##                  ###            
  #   #   #  #    #  #   # #            #    #    
  #    #      #  # ## # #     #     #   ##    #   
       #     #       #                  #     #   
#              #     #         ##         ##      
 #   #                   ###   # #        # #     
  #             #    #  #      #     ##  ##       
# #  #          #    #      #  #          ## #    
               #       ##  # #     #        ##    
#  #        #      #       #   #                ##
