#  # # #    #     #  #                       # # #
                  #   #  #             #          
 #     #                                          
        #    #         ##      #   #        #     
 # #               #          #   #       #       
         #       ##                      #        
  #                                     #         
     #   #           #                 #          
 #                         #  #    #  ##  #  ##  #
                  #   #  #       #    #           
                                             #    
    #                #  #       #          # # #  
       #        #     #    #  #   #    ## #  #    
             #              #          #        # 
         #     #     ##  ##  #  ##  ## #          
#  # #    #  #     #             #   ###          
           # # #               #      #           
        #     #  # ##   #  ## # #                 
#            ## #  #      #     #                 
    #                    # # #        #          #
#    #                   #      # #  #            
             # #      #   #          #      #  #  
       #  ##  #  ####     #                 ##    
   #                          #   #    #   #      
      # ###    #                  #         #  #  
#     #                  #  #                     
      # #      #             #   #                
 #               ##         #   #    #     #     #
                     #                            
     #                   #                        
                           #       #    #   #     
     ### #                                     #  
           ##  #     #        #  #         #      
     #       #    #      #   #     # #   #        
      #     #            ##                     # 
        #  #   ## # #  ####   #               #   
         #  #     #         #       #        # #  
                           ###      #    #        
     #      ##        #                     #     
 #  #   # ###          ##           #            #
          #                  #   #         #      
###  #     #  #          #                        
   #   #             #              #  #     #    
        # #      #     # #   #        ##      ##  
  #                          #       # #          
                    #   #   #     #        #      
    #   #          # ##         # #  # # #        
#   #             #   #   #     #    #  #   #     
    #  #   #         #      #          #   #   #  
   #      #                          #  #        #
