        #        #          #             #       
# #     #        #             # #         #      
     #      #  #        #   #               #     
 #             #                 # #     # ## #   
 #       # #     #               #     ##      # #
##  #     #     #                 #               
       #      #  #   #                ##   #  #  #
  #    #   #     ##  #                 #     #    
  # #         # #     #                           
                #      #  #  #       # #          
                          #          #    # #     
##      #         #   #       #   #   #           
         #            #   #      # #          ##  
#    # #     #  ## #     ##     ##      #     ##  
            #            #     #   #   #       # #
#    #        ##       #        #              ## 
 ##         #   #          #       #              
           #               #   # # #      #       
     #   #      #             # # #        # #  # 
#  # #    #                 #           #    # #  
    #   # #       # #                  #     #    
#  #      # #    #   #        # #          #     #
#                             #       ## #    # # 
      # #      #                ##             #  
              ##               #       #          
                      #     ##            #       
      #                      #  #       #         
                      #   # #                     
                                      #     #     
 #    #                   #                       
#    ##           #      #  #       #             
     # #           #                  #           
            #               # #  #           ###  
 # ##   #     #     #       #    #          #     
                    #          #     #            
             #          ##                #      #
#     ###   #     #              #    #           
     ##                             #       #   # 
        #  #       #  #    #  #             #     
      #        #  #   #       #      #  #    # #  
 #        # # #       #               ##   #     #
                #          #    #        ##    #  
      #        #                 #       #     #  
              #    #                # #  #    #  #
 ## #      #               # ###        ##     #  
   #      ## #        ## #         #      #     # 
      #  #   #            #  #     # #            
   #               #                          # # 
 #    #          # ##    ##  ##      ##       #   
      #                     #         #  #        
