   #        #      #                 #   #  #     
         #             #     ##               #  #
            #             #        #             #
#             #         ##  #  #    #  ##         
#    # #     #  # #       # ##     # ##        #  
  #               #           #  #          #   # 
     #  ##                    ## #  #             
#          #  # #        #   #       #   #  #   # 
  ##           #                      ##          
        #     ##               #          #     # 
#                           #     #  # ##  #   #  
   ##     #     #  #           ##                 
            #  #                  #     #         
       #      #       #        #   #  #           
 # #         #     #     #     ## #               
      #       ###         #        #            # 
# #               #                               
             ## #             #           ##      
      #    # #     #    ##      #              #  
###  #    #       ##      ##          # #         
  #                             ##       #        
             #   #          # #            #      
##         #           #      #                #  
  #     #                            #         #  
               #  #       #   # #             #   
                                                  
      #                      ##  #             ## 
            #               ##     #              
 #       ##  #        # #   #   #     #    #  #   
  #   #                                           
                 #                       #        
              #            #  #    #   #          
    #     #  # #         # #         ###   # ##   
    #  #   #    #            #   #      #    # #  
 #       #  #       # ##          #    #          
#        #              #       # #    #     #    
        ###                 #            #        
 #    #            ##        ###                  
    #  #          #  # #       #     #           #
              ##    #   #                     #   
          #                       #    #         #
#     #  ##           #      #           #   #    
 #         #       #   #     #   #     #          
#         #   #      ##                    # #    
  #     #  #             #   #   # #             #
 #      ##          #      #   ##     # # #      #
             #         #         #       #      # 
  #         #        # # #         #    #    ##  #
       # #            ##   #  # #          #      
#   #      #       #       #                      
