             #  #       # #  ###               #  
         ## #   #      #              #   #  #    
   #        #    #       #    #                   
                 ##    #             #      #     
#     #             #                   #       # 
   ##                 #        ##         #       
   #                  #                        ## 
                    #         #   #       ##      
                                      # # #     # 
      #  #      ##       #  ##         #          
 ##                         # #     #   # #       
         #    #          ###   #      #     #     
     #    #  #   ##       #     # #               
   #   #     #            #         #        #  # 
#  #            #               #    #   ## #     
  #    #        #       #  #             #        
      # #      #                          ##  #   
  #  #               #  #                      #  
   #   #  #      #     #         #    ##      # # 
                          #  #   #   #            
          ##      #    #          #     #         
 #     #        #  #  #               #           
 #  #        # # # #     # #     #       #        
     #         #          # ##        #   #  #   #
       #  ###     ##        ##       # ##         
 #             #    # #   #             #         
                 #      #             #           
 #                      #                         
 #           #           ##     #  #  # #         
#              #     #                            
   #   #     #  #     #   #      #  #       #     
#           #              #               #      
               #             ##       ##    #     
 #       #     #  #        #             #  #  #  
     ## # #    #            #             # #     
  #  #                  #  #         ##         # 
   #  # #          #     # #   ##    ###     #    
# #              #       #         ##    ##   #  #
         #    ##  #         # #                  #
      #  # #     #             #   #            # 
 ##  #   #       #   #   # #        #            #
          #             #       # #          #    
# #    #          #        #        #       ##    
  #         #                  #                  
  #   #  #     #       #   #        #  #          
        #             #             ##          # 
#      #         ##    #       #         #        
##                        #    #            #    #
 #             # # #          #           #    #  
  #                 ##       #              # # ##
