#  #    # #   ## #     #      #   #  # #          
#                # #  ##   #              #  ##   
     # #       #    #    # # # # # ## #   #      #
#     # #        #    #                     #     
 #     #      #           # #         #         # 
    ## ##   ##   ##           #                   
        #  #     #       #        # ##  #    #    
#          ###         #      # #      #  #       
 #          #   # #                 ##            
#       #   #      #            #        #     #  
  ##     #  #          #    #  #            ##    
 #                #   #        ##  #              
               # #  #         #                   
      #      #   #     # ###                   ## 
    #   #  ## #  #        #  # #                # 
             #        #                 #  # #    
  #  # #  #   #        #                          
    #      ##        #    #  #              #     
   # ## #           #    #   #   # #         #  # 
      #           #                          #    
    #   ##     #          #     #       ## ##    #
 #         #               # #    # # # #         
                 #      #  # #   #      #         
   #                     #           #    #    #  
  #   #   # #    #             #        #         
  #   #        #      #                   # #     
                                                  
      #           #   #                           
         #                  #        #      #  #  
  #  #              #                             
          ##  ## ###  #          #     #    ###   
 ##             #    #           #             ## 
       #      ##  ##          #      #     #      
      ###            #            #     #   #     
#      #            #         #  #           # ## 
 #    #  #  #   #                   #       #    #
       #  #               #                #      
         #   ####    #  ##               #   # #  
 #             #     #          #  #          # # 
     ##    #   #     #                  # #  #    
      #                           #             # 
    #   #         #          #     # #        ##  
 #  ###     ## #   #    #      #      #          #
      #                             # #       #   
  #         #         #            #       #      
                     # #   ## #    #              
#           #   #     #  #                 #    # 
#           ##               #       #            
     #   #  ##  #                       #         
              #   #      #   #                    
