    # #                  #  #       # ##      #   
                      #    #         # #  # #     
    #  #    #       #             #       ##      
       #             #     #  #   #  #    # #  #  
              #        #          #        #      
  #       ##    #     ##                #####     
                                                 #
                               # #                
 #  #    ##    ## #                 ##         #  
 ##    #     #    #    #   # # #          #       
  #     #  # #                   #   #      #   # 
 # #       # #      ##  ## ##       #      #   ## 
                                       #   #      
            #      #    #                   #     
    ###    #               # #           #        
 #          #  # #          #  # # # #            
           #      #  ##        ##                 
           #  #          #     #           ##     
   ##      ##  #          ##  ##   ##  #          
                #    #                    #       
   ##   #  #           #       ##          # #    
  ##     #           #   #      #  #            # 
              #  #  # #             #  #       #  
             # # #        # #  # #               #
  #            #                   #             #
#   #                     #  #          # #       
        ###              #       #                
  #              #  # #                 # # #     
#                ##     #                         
 #   #         #    #                             
 #           # # # #    # # #          #     #    
#   #   #  ###  ###  #                         # #
 #    #           #    #             #      #     
 #    #          #              #          #      
##      #      #            # # #       #       ##
      # #   #       #       #    #   #         #  
#                      #    #   #      #         #
      #     #   #          #   #   #  #   #       
  # #             #  #     ## ## #          #     
      #  #      #      #  #              # ##  #  
        #   #                 #      #     #      
    #    #            # #    #   # #  #    #   #  
 #         #  # # # #          #     #  # #   #   
         # #          #           #               
     #  ##   #      #  # #                 #      
           #         #        #    #  #        #  
  #      #             #  #             #         
#       #      #    #     #                 # #   
 #  #  ## #     #      #     ## #                 
        #        #                 ###  #        #
