 #        #      # #        ##   #                
      ##      #         #            #            
                     #       #                #   
 ### #    #                       ##      # # #   
                   #  #                           
  # ##          # ##  #              #            
     ##              #          #  ##  #  #      #
#         #   #   #    #   #             #     # #
 #  #  #     #      # #   #  # #     #        ##  
    #    ##          #          #          #  #   
#                                      #     #  # 
         #         #   #      # #            #  ##
#      ###  # #   # ##                   #        
      #  #   # #    #        # #         #        
                                   ##           # 
          ##   #  #       #  #     #    #         
  #                #              #   # ##        
           #     #      #     ##   #              
  #           #                      #  #   #     
         ## ##    #        #     #     # #   #    
          #      ##  #                 #        ##
                  ##      # #  #             #    
       ##    # #              #                   
            #  #          #  #  #    #       ##  #
#        #         #      # ## ##                 
#                        #                  #     
 #        #      #    #                     #    #
 #  # #           #             ##      #        #
 #  #                    #       #      # # #  #  
    ##                        #                   
     #           ##    # #               #  #   # 
  # ##   #      # #      #       ## #            #
     #     #     #                       #       #
                   #  #                           
                   ##     #  #   #       #     #  
              #    #     #   ##      # #   #      
          #                #              #       
 #     #  #            #                    ##    
    #                #        #    #        #     
##    #  #   #             ##                  #  
               #            #      #      #  #    
 # #                         #  #                #
        #  #                 #   #           #    
     #       #                      ##     #      
     #  #                 ##   #      ##  ## #    
            #      #        #                #    
      #          #           #     #     #        
         #  #        #   #   # #     #    #  # #  
  #       # #              #          #           
#            #          # #  ##  #   ##    ## #  #
