#    #           ##   # #           #        ##   
 # #       #  #  #       #                #       
    #   #       #    #   # #         #        #   
 #           #      #   ##       #   #    #       
    #     #      ##                            #  
   #  #              #  #   #                #    
      ###  #    #                     #  #     #  
          #  #                                    
                     ##      ##   #       # #     
    #      #    #              #     #       #    
          #  #      ##   #       #   #        #   
    # #        #        # #            ##       # 
 # #      #         # #             #    #  #     
   ##          # #   #           #    # #        #
                    #      ## #     #     #    #  
           #     #      #  #  #    #     #        
     #    #    #             #   #   #            
                                  ## #            
        #   # #              #     #        #     
 #     #  #                                   #   
  #    #       #      #            #      ###     
        ##    #                #     #    #  #  ##
       #       #               #         #        
  #  # #         #                   #    #  #    
                          #  ##             ##  ##
    #               #                   #         
 #                                                
##  #   #                          #             #
                                           #     #
                        #                         
   # #  ##     #   ##                #       #    
    #      #                     # #     #        
   ##      #        #   ##      # #      #     # #
##  #              ##        #    #          #   #
    #      #                                      
     #                 #              # #    #    
                  #            #      # #  #  #   
      #       #                ##                #
      #  #  #       #       #    ## ##            
 #                            #     #           # 
      ###                #        # #             
                 #  #     #         #      #      
 #   #   #        #  #      #      #  ##    #     
  # #      #         #         ##    #  #         
      #   ##        #         ##   #              
    #                      #                      
# #      #    #     ##   #  ##        #  #   #   #
#                   #         #         #  ##   # 
 #      ##           #      #               # #   
      ##  #   #          #             #          
