    #    #                    #                  #
     #      ##    ##  #  #     ##    #   #        
         #                  #     ##              
              ##             #      #  #          
        ##  #            #           #    #   # # 
    #        # #           #                #     
#     # #    #                                    
   #       #  #  #             #  ##    #       # 
#             # #                #     #   #      
    #   #   #  #      #     # #       #        #  
  #  ##     #  # ###        #   #      #    ##    
   #    #           ##  #       #    #   #        
   ##  #      #  ###       # #  ##        #       
      #      # # #  # #         ##       #        
   #          #     #  #      #                   
      #   #      ##             #            #    
       #            ##     #       #       # ##   
  #   #   #  #  #     ###            ##           
          ##                       #   #      #  #
     #  #  #   #     #      #     # #       #     
    ##   #                      ###             # 
     #  #  #          #  #    #    #           #  
 #   #   # #     #           # #    #   #   #     
#          #             #      # #     #  #      
        #  #    # #           #   #              #
          #          #    #               # #     
      #              #           #              ##
             #           #      #                 
                 #              #           ##    
                      #            #       #      
        #      #               #    #          ###
  # #      #   # ##       #    #   #              
     #    #        #     #      #  # #          ##
                 # #     #         #  #  #        
      #      #          #           #  #          
      #       #       # ##     #     # ## #       
   #  #           ## # #    # # #          #      
  ##  #          #   # #      #     # #           
   #           # #     # #  ##          #   #     
  #         #    #          #  # #          # #   
    #      #                         #    #       
            #       ##       #       #            
                 #            #      # #   #  #   
  #          ###                      #      ##   
             # #         #     #   #    #      #  
          #               #      # # ##     #     
 ##  #    ## #  #  #               #          #   
  #  # #             #    ##                 #    
        #           #   #     #    ##      ##     
   #  # #            ##       #          # #   #  
