   #   #              ##   #     #  #            #
  #            #     #  #      #             # ## 
      ##           #                         # #  
              #               #  #   #     #     #
           #    # #  #        #             #     
#  #            #            ###         #    # # 
   #   # #                 #        #       #    #
     #      #        ##                  # #      
  #     #        ##       #                       
             #    #  #         #        #         
         #          #            #   #   #        
#     #    # #        ##       #           #      
         #  # #              ##      #            
      #           #     # #          #            
      #                          #             #  
       #             ##    #             #       #
          #          # #                #         
                 #  #    #                 #      
    #            #     #                         #
   ##  #    #                  #          #    #  
          ## #                                    
     #         #  ##            #    #     ##     
 #                ##    ##        # #  #      # # 
     #               #  #  #      #   # #   # #   
            #  ##  #      #    #             #   #
                     #    #   #                  #
      #          ##       #                    #  
#                #  #   #    #  ##                
    #          #  #  #      ##                    
#                   #                   #         
               #                ##       #        
                         #       #          #     
       #      #      #   ##    ##   ##   # #      
 #  ## # #        #  #  #         # #             
  #     #          #          # ##     #  # #   # 
        #              #  #    #           ##  ## 
   #            #      ##    #                #   
  ##            #  # # #        # #         #   # 
            #             #    #      #         # 
  #         #         ##      #  #    ###   #  #  
#     #  #  #                                     
#           #            ##      # #              
 #    #              #       ####   # #     #     
            # # #       #    #   #         ##    #
#       #         #  #      #           ##   # #  
                      #    #             #    #   
               # #     # #    #  #   # #  # #     
   #     #                       #       #  #    #
           #               #   ##   #            #
 #    #              #   #        #            ## 
