 ###           #                        #         
     #     #           #      #                   
#                     #          #    # #         
      #     # #                #    ##      #   # 
   #  # #  # # #                          ##### # 
     # #   ##  #        #  #    #           #  #  
    ##           #         #     ##  #      #     
  # #   #   #     #       #      #   #            
               #   #    #   #  #       # #    # # 
 #               #         #       #      #  #    
 ## #         #               ##  #     #   #    #
#         #            #   #     #      ##        
  #       # #      #          #                   
    ##    #   #  #           #    #       ##   # #
 #   #  #        #   #            #     #   #     
  #     #            #   #     #   #     #  #     
    #         #                #            #     
   ##       # #                        #  # #     
    # #  #     #  #      ##                     ##
             #       #      #     #  #      #     
 #   ###                 ##                       
 # #           ##          ##  #             #  # 
  #                 # # #               #         
#        #  #  #   #    # #                 #     
###      #  #             #        #   #          
  #                                     #         
#                       ##                        
    #   ##          #   #    #        #   #       
                      # #        #      #     #   
  # #                #    #   #             #    #
      ###      #           # # # #    #  #        
 #                    ##  # ##               #  # 
             ##  #          # # #         #   # # 
  #     # # # ## #  #       #  #      #       #   
   #  #    ## #      #              #       #     
                # #           #     #             
 #    #  #                     #           #   #  
 #       ##        ##      #   #     #    #       
           ## ##  #     # #      #   #      #     
    #         ##      #   #     # #     #      #  
              #  #                  #             
    #              ##             #     #   #     
 # #    #                        #  ### #  #      
#    #             #             #        #       
       #                 # #      #  #          ##
                 #     #                  # #     
 #     #                #           #  ##     #   
#  #            #  #           #    #   ##     ## 
#     #  #    #   #  #      #   #       #        #
     #    ## # ##        #     #          ## #  # 
