          #         #    #    ##                  
   #                      #                       
    ##     # #         #              #      #    
         #   ##        #          #       #       
       #       #     #   #    #        ##   # #   
#        # # # #  #    # #        #               
     #        #  #  #      #   #           #  ##  
    # #     #   ###   #  #     # #   #      #     
  #       #              #                    #   
              #  #    #    ##           #     ##  
     #         #   # # #  #      # #         #  # 
             # #    # ##  #              #      # 
   #  # #   ##         #  #  # #     #  #         
    # #      ###    ##              #      # # #  
#    ##      #          ###   #   ##              
 #  #                  # #                        
                                     #            
     #      # #      #        #    #    #         
   #  #   #            #     #  ### #    # #     #
#  #       #     # # #    ##     # #      ##      
    #                            ## #          #  
# ##             #                  #    #  #     
        #               #  #       #     #        
      #              #      # #  # #              
 ##                                 #             
               #     #  # #             #         
                            #    #             #  
 #    #  #  #       # #     ##              #     
 #           #      #                ##          #
                                                  
   #       #    #            # #          #  # # #
   ###    #            #       # ## #  #  #   #   
  #      #         #      #       ###      #      
   #         #          #  #        #  #        # 
  # #                              #   #     #    
                  #     #       # #  #      #     
     # # #      #             #          #     ## 
#               ##              #     #   ##  #   
  #      ## #### #         #      #   #  #        
    #         #                         # #       
#                      #           #    #        #
                    # #            #            # 
    #           #     #         #   #          #  
           #  #               #      #         #  
        ##        # ##                 #  ### #   
   # #   #     #   #  #   #      #               #
      #                               ##  #  #  # 
  ## #     #     # ## #       #            # ## # 
        #      #          #   # #             #   
      #                # #                #    #  
