                 #     #    # #  #        #      #
      #       ###  # #     #  ##    # ##         #
  #    #    ##  #   # #         #                 
  ##                    #   ###           #       
                     #          ###        #   #  
  #         ##  # #                   #         ##
# # #   #  #     # # # #      #   #         ##   #
      #        #                  #          #   #
#  # #                 #                         #
    # ##           # #  #   #                     
  #          # #   #                       ##  #  
        #     #          #   ###        #       # 
  #  #              #  #      #      #            
             ###  #      #       # # # #         #
                       #        # #   #   # #     
     #      #     #    #           #     #   #   #
#  #    #        #          ##              ###   
    #       #       #    ### #                    
#   #   #      #  ###   #    #       ###        # 
      #     #   #  #           #             ## ##
 ##     #       #    ## ## #    #               # 
        #      #        #      #   #        ##   #
  #   #               # # # # #  #                
 ##       ##      #       #                       
      #    ## #     #               #         ## #
    #                 #      #                    
      #                            #           #  
        ###           # #          #              
     #                #                    #      
                                   #              
 #      ##    #                 #     # ##        
       ##  #        #          #      #      # #  
   ##    #  # # # #              #      #   # #   
     #    #                                       
#  #  #     ## #    #           ##    #      #  # 
        #                  #         #       #  ##
 #    #      #         #        #  #           #  
 # #  #       #                     #             
        #   #          #      ##      #  # #      
           ##        # #      #  ##      #    ##  
  #          # ##  # #         # # #     #    # # 
           #  #  #     #            ##  #   #     
       #  #                      #   # #          
#               #          ##   # #       #       
   ##     #       #  #          # #           #   
       #  #    #                      ## #        
    #                #    #   #            # ##   
     #  #   #   ##               #           #    
 #  #    #      #                                 
                         #                        
