 # #  #      #          #  # # #            #     
  ##     #           ##             #    #        
  #                              #  # #  ##   #   
           # #                   #     ##         
     #   #       #     #    #              ## #  #
  #   ##         #         #    #   #          # #
          ## #           #                     ## 
         #     ##  #     #        # # #        #  
           # #     #  #   #   ##          #       
                    #     # ## ## # #   #  #      
      #                #    #    #  #     #     ##
    # ##           # #         #    #             
         #          #   #      #     #      #  # #
#             #        #        #    #  #         
                  ### #    #            #  #    # 
         #       #         ###             #   #  
     # #    #   # #         #             #       
     ##    #          #   ##          #  #        
 #      #      #   #    #    #    #    #          
     ##                      #                   #
          #       #                 #       #     
 #      #   ###  #    #      #           ## ##  # 
      #                  #    #       #           
                         #    #   #        #      
       #                         #  #  #          
#         #                                      #
            #                    #    #         # 
##      #             #               # #   #     
                        #    #   #            #   
                                                  
##              #   #  #             #            
  #          #    # #        #      #    #        
        #       #  #   #    #                #    
            #      #      #    #        #   # #   
                 #           #   #   #     #      
#         ##         #     # #  ##                
          #     #     ##                   #      
   #    ##  # #                       #          #
 #    #     ##   #       #                   ##   
      #               # #            #            
      #        #             # #       # #    #   
           ##  #              #         #         
 #  # #          #       ##   # #  #             #
 # #     # #    #  #  #                         # 
 #   #   #           #                       # #  
    #    #     #           #   # #            #   
        #           #                  ###  # #   
 ##   # # #  ## # #     #                         
  # #   #  #    #   #            # #  ##  ## #    
 #             #   #    #       #      ##  #      
