#      # #      #        #  #                     
        #            ##           #  #            
    #   #     #     #    #            #           
     #  #     #    #   #             #  #    #   #
  #####     #    #    #   #      #         #    # 
 #       #      # #  #      #        #            
   #          #  #   #  #             # #         
     #   #               # # #        #      #   #
    ##      # ##         ##      #   #  ##       #
       #         # ##        ##    #              
   #       # #                            #       
#      #         #       #   # #  #  #     #  ##  
#      #  #     ##         ##                #    
     #      #            ## # #  #  #   ##        
            #        ##  #    ##      #    #     #
      #                           #  #      #     
         # #    #               #        #    #   
  #       #  #           #  #       #           # 
    #    # #  #                                   
                   #      #           #           
               #      #       #            #   #  
  #       #              #         #       #  #  #
    #  #        # # #     # #  #       #          
   #  #         #    #                   # ##  #  
          #  #  ##          #                  #  
          #              #                        
                    #   #     #                 ##
         #          #                   #   #     
                         #  #                     
                                                  
# #   #     #       #       # # # ##  #         # 
          ##  ##        #   ##   ### #    #    #  
 #  #   ##                                        
   # #   ##      # #            #   #  ##   ##    
#   #  #   #     #                   #     # #    
## #    # #          #   #    #      #    #  # #  
        #       #    #   ##   #    #           #  
 #    # #    # ### #        #                     
#       #            #            #       #       
     ##     #    #        ## # #             #    
          #      #    #  # #  #         #   #   # 
        #       #             ##     # #          
                     # ##            #       #  ##
 #  #           # # #           #   #  # #        
    # #     #  ##     # # #    #     #    # #  #  
         # #               #  #   ##     #        
    #        ##                #   #  #         ##
     #          #  # #  #       #                 
                 # #  #  # #                      
         #   # #   ##               #          #  
