          #    #   ### ##            #            
              #   #    #             #      #     
         #            #                    ##     
 #       ##      #                       #   #   #
   #   # #                   #     #        #     
        # #     #   #        # #    #  #     #  # 
 #         # #   # #             #  ##          # 
#        ####   #           #              #      
 #                #                 #             
#        # #                ##   #     #          
  #     # #            #   #        # #          #
      #     #   #    #             ##         #   
             # #    # ##            #       #    #
 # #        #    #          ##  #                 
  ##             # #                #           # 
  #          ##          #   ##             #    #
# #               # # #                  #    #   
          ### #   #      #   #               #    
  #   #                # #  #  #     #            
#        #   #    #      #      ##      #         
               #    #       #    ##       #   # # 
   # #         #  # #     #                       
  ###       #   #     #    #     #####            
           ##   #       #     #             #  #  
            #   ##        #    #                 #
                      #            #              
               #             #  #                 
#    #            #                               
  #   # #            #                         #  
#     #  #                              #  #     #
    #        #  #          #        ##  #    ##   
      ## #  ##           #                        
       #            # #                 #       ##
                   #          #          #        
     #      #            #              #    # ## 
          #       #     #             # #      #  
#   #              #                #   #         
    #     # # #  #         #     # # #  # #       
                 #                    #           
     # # #     #  #          #   #   #         #  
              #          ## #   #   #     ##  #   
   #     #           ##            # #      #     
 #  #          # #            #    ##  #  ##      
          #                    #        #      #  
           # # ## #         #   #       #      # #
  #     #  #  # #           #         #        ## 
     #    # #            # #  #    #      #       
                 # #                #     # ##    
         #    ##              #                 # 
  ##        #               #     #      #      # 
