   #      #  #        #     #      ##         #  #
 #      #          #     #            #  #        
 #  #          #               #         #     #  
   #          #        # #      #   #      ##   # 
   # ##  #         ##      #    # #  #      ##    
          # #       #    #   #          #         
 #   #               #     #             ##  ###  
   #    #     #  #     # #    #         #   ##    
                      ##            #             
   #                   # #        # #             
#               #            #   ##   ##   #    # 
  #         #      #               #        # #   
    #                 #    #                   #  
              #   #  #    #       #  #   #  #  #  
                              #  #                
             #   #                  # # #         
#       ##   #            # # # #         #       
       #  #        #     #           # #        # 
  #        #  # ##        #    #   # #        #   
       #      #            #      #   #         # 
             #     #  #      #            ##      
       #          ## #  #    ##       # #     #   
 #        #               ##    #               # 
      #           #        #         #            
  #        # #                 #             # #  
    ##                                            
                         #   #        #           
            #  #          # ##        #          #
         #              #     #           #   #   
  # ##               #  #                         
 ##       # #    #                      #         
             #      #             #      #    #   
   #   ##    ##            #           #      #  #
       #      #                 ### ##        # # 
         #    #      #            # # #  #    #   
  #               #   #     #     #   #       #   
                   # ##    #   #         ##   #  #
        ##    #       #   ## # #  #  #            
   #        ##       #       #   # #              
       ## #      #            #  #           #    
   ###        #            #                  #   
 #          #          #         #           #    
        #     ###  #   #     #          #  #     #
         # # #           #      #  # #    #     # 
     #         #  #             #    #     ###  # 
             #         # #       ##  #    # #     
      # # #                       #  #  #         
    #   #          # #         ##            # #  
          #  ##       #                 #         
  #             #       #   #            #     #  
