           ##         #        #     #   #       #
                            #     # #        # #  
 ##      # #   #       #       # # ##  #   #  #  #
                 ## #   #   #     #        ## #   
          ##    #    #        ##     #      ###   
  #   #               ##            #   #         
    ##     #                    # ##   #   #  #  #
 #                           ##      # #          
           #    #  #         #        #      #  # 
#  #         #        #  # #   #      # #   #  # #
           # #        #    #        #      ##     
   #                               #    #         
       # #    #   #  #  #    #                #   
  #                  #                 #       #  
     #              # #       # ##             #  
  #                 # #     #      #              
   # # # #  #    #     #                      #   
 #    #                #  #               #   # # 
   #           #      #              #           #
    #      #     ##               #    #          
 #          #                           # #     # 
   #         #      #                    ##     # 
                  ##  #  #        #               
#    #   #    #   #        #  # ##   #  # #    #  
        #        #  #     #                      #
                                            #     
                     #   #   #          #   #     
 #  #                   # #             #   #    #
    #   #                 #  #   #   #       #    
#        #                                 #      
#     ###      #     ## #                    #    
 #  # # #     #  ##         ##  ##                
 #     #    ##       #       #       #        #   
         #  ##     #                  #      #    
              #        #  #            #          
      ##     #  #   #  #   ##      #  #         # 
  #     #       #   #                 #    ## ##  
       #        # #          #   #   ##           
              #             ###           #      #
  #    #         ##            # #    #        #  
  #            #     ##  #  #      #  ##      # # 
# #               #    #    #    #       ## #    #
  #           #               ##     #     #    # 
              #    #   ##                #        
     #                     #     #                
                 #                #      ##  #    
#      ## #### #       #   #        ##  #       ##
 #   #                       #        #           
#    # #       ## # #  #   #           #          
#     ### # #     #   #   ##                    # 
