         #       #        #  ##             #    #
 # #   #  # ##          #     #  ##      #    #   
           ## # # #     #  #      #   #  ##     # 
  #           # #         #         #       ##    
   #  #                                      #  # 
 #       # #  #    #         #                  # 
 #   ##        #        ## #        # #           
             #         #       #     #   #        
     #        #  #       #     ##      #       #  
       #     #   #       #  # #    #              
      # ##    #             # #       #        #  
          #    # # #                  #     ##    
#        #     ##          #     #   #     #    # 
   #               #                         #   #
    ##      ##    #      #       #               #
  #       ## #         ###     # # #          ### 
# #                           # #             # # 
  #          #  #       #  #      #     #         
 #    ##  # #                  #    #    #       #
#    ##       #           #        # ##   #   ##  
                                   #             #
##                 #  #   #       #   #     #     
 ##   #     #                 #    # ###    #  #  
   #  # ### #       #      #   #      #           
            #                           #   ###   
                                        #        #
  #      #            # #                         
#    #               #       #       #           #
 #               ##                       #       
  #     #           ##        #           #       
 #         #            #  #                ##    
    #                 ##       #        # # #    #
#    #       #      # #                     #     
  #   # ###      ##     #       # #  #     # #    
  #           #        #              # #         
#    #    # ##      #      #    #                #
        ##       # #     #                      ##
                    # #                      ##   
           ##          #    #   # # #   #   #    #
      #           #                               
#        #           # # # #   #  #     #         
      #     ##    # #      ##                    #
  #      #             #         #       ###   #  
#  # # #  #         #               #           # 
          # # #                #          #      #
                    #      #   #     ##           
  ##      #    #        #    #    #     #  ##     
  #        #    #  # #  #   # #                   
       #  #              #    #    #      #       
    #     # #     ####                         #  
