     #            #      ##    ##      # #     #  
                             #   #      # #  #    
            #  #     #                       #  # 
          #   #              #                    
#     ##    #       #               #  # ##    #  
  #     #     # ## #                        #    #
#    #    #                      #  #   #      #  
           ##                            #      ##
#            #                      #     #     # 
           # #          #                      # #
                   #  #      ##  #     ## #       
    #     #     #        # #    #             #   
   #   # #  ##   #   #        #    #   #   ####   
       #   ##        ##         #         #       
                 ##           #         ##    #   
           # #               # #                  
   #    #       # #        # #   #     #        # 
                 #  #               #    #        
             #         ##       ###     #  # #    
         #    #    #     # #   # #      #         
               #            #        # ##   #     
       # #   # #                    ###           
         #   # #  #      ##    #         #       #
     #   # #     #   #       #  #    #  ##    #   
           #              #                  #    
#     #                                           
               #        ##            #           
#              #  #         #    #                
        #        #        # #              #      
                    #                             
    #   #    #   #            #              #  # 
  #      #    #       #     #            ##       
        # #     ##  #    #  #   #      ##    #    
 #    #               # #    # #  #  #        #   
  #   ##          #                 #             
#                        #  #      #     #     #  
          #       #   #             ## # # ##     
 #   #     ###  #  #      #        # #  #         
  ###     ###      #              #        # # #  
    #   #        #                        #       
## #             ##        #  #        #     #  # 
     #                      # #     # #           
  #         #      #    #       #    #       #  # 
              #      ####           #  ##  #      
   #  #  #         #                            # 
     #       ##  #          ##       #    ## #    
 #             #              #  #     ##     #   
       #    #               #        #     #   #  
                #           #       ##            
         ###      #     # #           #  #        
