       #    #   #              #      #           
#         ##           #      #       # #    #    
  #       ##   #  #  #    #       #            #  
#    # ##                           #    #      # 
   #          #      #        #    # ##        #  
                                             ##   
   #                    #         #           ##  
                 #             #          #       
  #  #    # #    #   ##   ##       #  #   #      #
               #      #  #        # # ##       #  
    ##                             #  #           
# ##   ##             #    # #     #         #    
   #       #     #         # # #   #              
#         # #                #   #  #    # #     #
            #                #    #            #  
                       # # #     ##         ##  # 
  #  #      ##      #                #       ##   
                # #        #      ##              
      #           #    #  #      #                
#      ##                   #       #    #        
   #   # # #      #          #          #     #   
     #  #  #      #  #    #     #   #  #   #    # 
  # #       #    ##            #        #         
 #            #           #  #    #   # ##        
#         #         #                             
 #   ##   #         #                             
#     #      #       #           #    #         # 
 #   #       #   ##     #          #             #
                  #          #   #         #   #  
               #                                  
      #       #  #                   #         ## 
  #              #    #          # #             #
  # #              ##        #  # #               
    #     #          #     #     #    #           
  # ##   #              ###    ## #  ##           
 #       # # # ##   ## #  #     # ## #       #    
   #        #                # #                  
       # #      #    ##  #   # #   #              
    #  #          ##    ##  ##      #    #      # 
                # #   #    #   #   #    # #     # 
       #       #        #                  #  #   
   #  #                        # #    #       #   
              ##               #       #         #
 #      #   #            #         ##           # 
         #   #      #    #       #                
                 #  #     #     #    #         ## 
                   #        #       #      #  #   
  #               #             #   #  ##         
 #     #         #  #    # #                      
       #      #          ##      # #  #    #  # # 
