                ##    #   #     #   # #  #     #  
    ##         #       #   #            #         
 #          ####        #                         
       #     ##  #          #    # ##         #   
                # #         #     #            ## 
          #     #      #   #          #  # #  # # 
        ##  #    #        ##  ## #  #         #   
      #    #       # #              #  #          
#        #         ##   #  #      #    ###        
 ##    #   #       #   #      #       ###      #  
   #     #        #    # #             # #        
 #              #     #         #    #            
                 ##     ##                        
                    #             ##  #    #   #  
    #  #      # #    # #   #  # ## # #      #    #
       ##      #        #    #       ##           
  #                                      # #      
  ###     #            #  # #   #   #         ### 
 #   #    #                     # #      ###   #  
     # #            #      # # #         # #      
 #                # #         #   ##       #  #   
 #   #         #    #      #    # #               
         #        #   #  ## # #               #   
     #           #  # #    #    ##   #            
       #                            # #     #     
  # #          #         #                        
#                         #     #       #         
        # #           #      #  ##                
          #    #                     #    ###     
                     #                            
   # # #       #               #                  
     #     #   #    #  #                          
      ##       # #   ##  ##      #           #  ##
  #                   ## #       #   #      # # # 
         #     #        #      #    # ##          
#  # # #       # #     #        #  #            # 
##                          #            #     #  
     #        #         # #     #     #   ###   # 
 #        #      #      # #     #       #    #   #
    #     #   #            #          # #    #    
       # #   ## #  #      #  #         #          
     #                    ##  #                   
                              #         # #  #    
  #  ##                 #               #  #      
  #    # #      ##     # #                    #   
         # ####     #            #         #      
 #       #           #      #   ##        #  ##  #
             #     #             #    #           
               ##   #      #           #    #     
              #     #       #                     
