         ##      #            #   ##              
          #              #    # #    ##     # #   
 #          ##         #           #    # # #     
    #   #               #       #     #   ##  #   
      ##              # #    #   #     #    #     
                  #     #     #  #  #           # 
 #           ## #  ##            #                
  #   #     #         ##                  ##     #
                  #     #                         
             #   # # ##           #    #   #   ## 
 # #     #     #           #     #  #             
  #   ## #                        #          #  # 
                                        #         
       # #             #                          
  #    #        # #      #         #           #  
   #        #          # #    #                  #
           #   ## ##          #       #         # 
                             # #           # #    
 #          #         #   #              #        
              #  ##           #  #   #  #         
     #        #                                   
#      #  #  #   #                  #        #    
  #   #         # # #     # #                     
               #  ##  #      #       #     ##   # 
         # #                            #         
###       #          #                      #     
  #                     #   #                     
     #                           #    #           
         #       #              #                 
 #                      # #   #                   
#     # #     #     #                     ##      
                 #   #              #           # 
 #        #    #          #            #          
# #  ##     # #             #                #   #
               #        #                         
#   #      #                      #          #  # 
     # #     ## ##               #  #     #       
              # #     #  #      #    #            
        #             #             #           # 
 #                #     #    #    #      #        
     # #                       #    #     #  #    
    #    #  #  #           # #    #    ##      #  
    #     # #  #    ##  #   #    #  #    #        
                  ## #   ##        #     #        
#            #  #                   ##        ### 
                    #          #   # #     #      
     #     #     #    # #          #  #  #        
    #    #   #   #   ##   #  #       #            
#            #                          #     ####
       #         ##   #     #        #       #    
