#     ##  #  ##  #       #      #   # #       #   
   #    #                 ##    #            #    
 #               #                          #    #
  #      #   #      #  # #     # # #      #       
                   # #     # #    #   #       ##  
  #     #            #                #      #    
  # #       #  #      #    #   # # ##             
             ## #     #     #   # #  #    #       
##                         #    # #  ###  #    #  
   # ##                    #  #    #        ###  #
 #   # #       #     # #             #  #        #
    #        # #           #               #      
     #   #       #       #  #  #     #           #
#   #      #               #       #  #   ## #    
        #    #         #                 #        
     #          #  #     ##    #  #   ##         #
       # #    #                 #  #              
#                  #  #   # #        #            
                #       # #   #               ##  
 #    #    #             #          #     # #     
#  #    # ###                 #                #  
                         ##   #   ##     ###      
    #              #         #       #        #   
#        ##      #        #                     # 
         #         #      #   ##     #            
    #                    ##        #      #       
      #             # #     #    #             ## 
          #             #    #   #                
     #         #             #            # #    #
#        #          #                             
 ##               # #                      #      
        # #   # #  #             #     #          
 #  #   #   #          ##                 ##    # 
  #        #     #    #             #   ##  #     
        #           #    ##                    #  
#                        # #    #         #      #
#   #       #           ##           #    #  #  # 
 #   #   #   #                 #         #  ##    
      #                     #    #   #            
    #         #  #  #  #   #  ##    ##      ###   
       #       # #              #     #   #       
  #     ## #      # # #     #   #                #
         #     #         #     #       #          
 ##          #          #         #    # #        
      #          #         #             #        
     #       #      #         #                   
  #  #               #      #      ##         ##  
    #     #           # ##                        
   #  ##         ##       #    # #            #   
#               #                       #       # 
