     #      #      #       #  #       #  #  #     
##       #         # #    #        #            # 
            #      #  #      #      #  # ## #    #
      #           #           #  #       #        
                     # #  #  #    #      #     #  
# #                  ###    #   #                 
     #                #    #                 #    
  # #   ## #             #     #  ##         #    
    ##     #                               #      
      #                   #       #   ##        ##
        #                      #               # #
 #      #      #  #      #  #       #     ## #    
                        ## #          ### #       
           # # #              #            #      
  # #                     #       #  # # #       #
     #    ##       #                              
  #        #   # #      #       ##   ##           
#       # ##           #   #                #  ## 
    # #   #       #  ##  #         #    #         
         #         #  # # #  # #             #    
 #           #               #     #    #         
       #   #    ##       #                  #  #  
                 # #               ## #           
  ##                       # #    #  #     #     #
                                     #  #     #   
##    #              #                      #     
        #         #   #   # # #       #       #   
                                                  
    #        # #        #            #            
                          #                       
#    #           #                        #   #   
                   ##   #               #   # #   
        # #   #         #                #        
          #   #      #          #         #       
      ##    #           # #                #      
  #                 # #    #    #         #   #   
 ###   # #           #  #           #           # 
   # #      ##                       #     #    # 
 #                        #       ##              
  #               # #                 #           
            #      ##           #      #       ## 
#                                                 
#         #                  #       ## #         
    #     #       #  #   #    #       #  ##       
       #   #   #            #  #    #             
 ##   #                   #       #  #  #   #     
 #       #            #   #   #         #         
     #    #            #      #   # #         ## #
    ##               #               #         #  
        # #    #   #    #     #### #    #   #   # 
