              #               # ##          ##    
  # #   # #         #        #                  # 
    #          #       #    #                    #
#        #   #   ##   # #       #         #       
                            #                     
  #   # ##   #    #             ##       #  #  #  
# #        #   #        # ##        #            #
   #  ##                  #   # #                 
       #  #      #   #    # # #      #         # #
       #  #     #      ##    #    # #   #         
 #      ### ## #     #   #  #       #         #   
      #                   #       #               
         #  #  #                         #   #   #
          #           # #                        #
      #  #                    #  #   ## # #     # 
     #  ###  #          #  # #              #  #  
   #      #         #  #                 #      # 
    ##    #   #         #                #  ##    
#           #    ##         #                 #   
              #         ## #      ## #       #    
#         #    #                          #       
      #       #     # #          #      #      #  
  ##  #     #       #     #     # ###      ##  #  
   ##       #                       # #           
       ##         #              #  #       #    #
                            ##                    
                  #           #                 # 
             #      # #                           
    #          #              # #     #           
                    #                     #       
                 #        #         #   #     # # 
                     #      #                     
   # #        #         #       #              #  
#            # #  #    ##                    #    
      # #                  ##    # #  #       #   
         #  #  #      #     #   ## #          #   
      #               #    #       #   #  #    ## 
                 #  #  #     #                    
         ##  #   #           #      #      #  #   
  #        #   ### #      #            #   #      
     #        #    #              #    # ##      #
#        #  #                 #      # ##   #     
##             #         #    #   #             ##
     #                        ##  #               
   #  #               ##       #                  
   #   #             #                            
#       #       #    #        #  # #              
  ###                     #           #  #  #     
      #          #    #      #                    
#            # #                 #    #  ## ##  # 
