               #  #                      #        
   # #     #   #               ##  # # #     ##   
          #      ##    #            #  #          
 #      #  #  #  #        #           # #   #     
#        # ##     #          # #            #     
           #         #          ###               
#     #   #      #                      #  #      
#      # #                  # #       #      #    
 #        #    #          #                 # # ##
  # #   #   ### # ## ##    #   #   #              
                 ##    #      #     ###     #   # 
 #                                           #  ##
         #    #           # #        ##           
     #  #    # #        # #  #       #     #    ##
   #  #  ##   #            #                      
     # #    #   ###     # #    #         #   #    
  ##    #  #        # #   #        #        #     
  #   #        ##          ##        #           #
         #    # # ##             #      #   #     
     #    # #           #  #            #       # 
   #   #   #   #  #    ###      #  #              
 ##          #    #           #  #     #          
#            # #  #    #       #              #   
 #        ##               # #               ##   
#          #   #                      #           
                              #                  #
               #  #       #   #                   
 #       #     # #                 #              
                  #  #       #   #            ##  
  #            #          #                       
                 #       #  #    #     #   #  #   
      #    ##   # #     #         # ##  #         
#    #       #        # #       #              #  
     #      #                # #    #  #          
# #                         #       #      ##     
  #            #          ##        #             
                       ##          #  #   #       
#         #   #   #   #     # #                 # 
    ##  #       #   ##                 #  #   #   
            #   #     #   #                       
    ##             #     #      #    # #     ##   
       #              #   #   #     #   # #     # 
     # #  # #   #               #              #  
              #     #     #            #    #  #  
    #     #     ##    # #     ###  #  #  # # # # #
       #        #      #  #    #            # # # 
       #   #            #        #     ###        
 # #        #         #      #      #             
     #      #                 #  #     #          
  #      #  #         #        #         #       #
