#  ##    #                     #             #    
   #        #   # #     #   #           # # #  #  
   #   # #        #             #          #  #   
  ##            # #   # ##                     #  
   #        #        #   #                        
    #           #             ##   #      # #   # 
   ##     #      #    # #              #          
#    #                       ##          #  #     
 # #         #           #       ##        # #    
          #  # # #  ###    ###     #    #         
                  #        #            ##        
        #              #                        # 
   #   #         #                             #  
#       #  #      #           #          #      # 
             #    #  #    ## #  ###              #
 #     ##    #          #   # #   #               
    #               ##        #         #        #
     #  #                  #####       #  #      #
         #           #  ##          # #           
# #        ## # #      #  #  ###    #             
  # #   #    #           #   #             #      
  #   #          #         #           #          
      #         #          #   #      #    #   #  
   #    #    #        #           #       #       
            #       #        #               #    
                        #    #            #       
      #  ##  #       #    #                 #     
               #  #                               
#        #     #  #  #    #     #                 
# #  #  #                #         #              
                ##       #          # #  #   ###  
#       #     #    #              #               
 # #        #        #    #       #     ##        
            #       #   #  #            #       # 
        #                  #   #               #  
       #           #    ##    #    #  #           
   ##           #                            #    
    # #      #               #       #            
         #     #           #  #      #  #        #
      #     #    #        #    #    # #           
    #                  #  # #             #     # 
###  #           #     #      #        #  #       
       #    ##      #     #         #      #      
   #  #          #       #   #  #      ##    # ## 
#    #     #      #  #            # #   ##        
            #                            ###      
  #       #                 ##   # #            # 
                #      ##             #          #
   ###          #             #    #    #  #      
#      ##              #   #     # #    #         
