                ###   #        #                  
  ##   #    #   #    #      #    # # #            
 #      # #           #       #     # #      ##   
               #     #        #          #   #  # 
    #    ##    ##                          #    ##
   #   # #           #                #   # #    #
    #                 #       #              #  ##
   #       # # #     #      ##   #        #   #   
# # #        # #               #      #       ### 
               #          # ##              #     
                     ###  ##   ##       # #   #   
   #   #                                ##        
      #    #        #            #        #       
   #    ##           #  #    ##       ###   ###   
         # ##                                     
           #    ## #                              
##      #                     #   ##        ## #  
        #        #  #                 #     #     
   # #    #       ##       ##                     
    # #   #   #     # #       #   #    #          
#      ##  #            # ##              # #     
       #       #        #                    # #  
     #     #                     #         #      
      #          #       #   #     #        #     
  #                       #      #    #     #     
                        #   #                     
  #              #  #                #  #   #  # #
    #             #   # #                         
          #                                       
#                                                 
    #         #    #        #   #  #      #       
   #   #    #                                     
 #      ## #           # #     #      #           
          #             #         #   #  # #  ## #
           #           ##      #              ### 
       #   #             #    ##                  
#            #          #  ##   ##          #     
 #       #  ##       ###     #                 #  
#   ###  #     #    #    #      #  #     #    ##  
#                #                  #        ##   
   # #            #              # ##   #  #  #   
     ## ##         #       #                   #  
 #                 #         #     #  #     ##### 
   #          #    # ##              ##           
        #   #  #             #  ##                
 #                    #    #        #             
            #  #       #              #          #
          #     #       #          #        #   # 
                                  #   ###     #  #
#           #     #  #  #      #  #  # #     #    
