    #  ##             #        #      #    #      
   #    ##               #        #               
      #                         #    #    #       
    #                # #      #               #   
#      #  # #    #                #              #
         ##  #   #          #                     
               #       # #    #  #                
      #  #    ##     #  #        #                
           #               # ##          #    #   
           #     #   #      ## # #   ##        #  
 #  #    # #  #   #             #         #      #
 #         #   ##             #   #    #        # 
 #             #            #           #      #  
         #    #          #    #         #         
                  #       #      #    # #   #     
       #               # #                    ## #
 ##   #       #  #   #                 ##    #    
    # #             #    #    #    #        #     
   ## #     ##   #  #   #              #       # #
            #              #     #     #        # 
    #  #          #            #       #     ##  #
              #       #   #    # #        ###   # 
  #     #        ##                #              
            #         #    # #  #   #             
#        #   ###             #                    
    #                 #     #               #     
             #   #   #    #   # #       #     #   
        #         #                   #    #      
##                  # #  #   #                    
#              #                           #      
#   ## ##  #     # #    ###    ##    #  #    ## # 
    #          #      #               #           
       #         #  #       ###               #   
                # # ##   #        ## #     #      
#      # #                                 #      
       #     #                               #  # 
 #        #      ##    #  #        #        ##   #
 #                       #     #  #       #       
    #               #       # #             #    #
#               #    #   ###    #               # 
          # ##                ##  # #             
 #       #                 #            #         
##   #     #   #         #         #              
      ##     # #        #                    # #  
 #           #    # #                #            
#         ##          #    #         #      #     
   # ##    #                  #    #  #           
        ##         #         ##      #  #         
#     #                 # ##        ##  # #       
 #     ##           # # #     # # #          #    
