               #    ##   ##        #    #        #
  #   #        # #       #  ##    #      #        
    #    #   #           #   #    #      #        
  #                     # #           #  ###      
   #   #               #                        # 
              ##                #    #            
 #  #              #            #   #       #     
 #                 #               #       #      
  ##      ##        #       ##       ## # ##      
     #  #  #  #         # #           #  #    ####
#   #    #                ##    #     #           
    #  #  #   ##  #            #                  
        # #                #     #   #         #  
    ## ##      #  #    #     # #          # #     
    ##    #   ##     #            #          #    
   #           #    # #               #       #   
#     #          #   #     ##  #    #           # 
        #  #  #  #    #  #  ## #  # #    #  #   ##
    #  #                #          #   #    #     
      #   # # #   #  #     #      #               
    #     ##      #  #   #     #   #    #        #
         # # #                 #   # #        #   
        #              #  #           # #         
   ##       #                        #            
#         #  #              ###                   
                                                 #
          #      #        #                     # 
      #             #                 #          #
 #  #                                       #  #  
                              #                  #
#          #      #  #    #                       
                  # #      #             # ##     
  #       ##      #  # #    #         #      #    
     #       #              # #     #             
         #               #              #         
   ###             #    #      #                  
   ##    #                    #         #         
   #  #          #       #        ##   #    # #   
#      #   #    # #   #    #    # #               
  #   #   #     ##           #       ##        #  
               #  #      #        #    ###   #    
 #     #   #    #         #     #      ##       # 
   # ##      #    #       # #        #           #
         #    ##                    #             
                                               #  
     # #        #        #                        
    #               # ###    ### #          #     
   #       ##      #   # #  # #              # ## 
# #   #   ## #     ###            #              #
# #            #         ## #     #           #   
