     #        ##        # # #       #   #         
 ##  #           #   #   #  #   #    #            
      #  # #  #               # ##        #       
    #          # #               #  #       #    #
     #       #    #     #        #      #     # # 
#        ##    ##           ####                  
     #     #                                 ##   
 #              ##  #  #   ##  #     #  #         
# #      # #    #       #    ##            #   #  
        #  ###            #   #   #               
      #  ##   #          #  #          #       #  
       #  ##    # #  ##    #                   #  
                ##  #  ##  #      #   #  #        
   #            #            # ##     # ##        
                   #                             #
    #     ##       ##      #              #       
      ##   #          #      # ##  ### #    #     
  #  #    #  #  #         # #     #   #   #     # 
##     ## ##               #          ##   #      
    # # #    #         #                #         
          #        #      ##                   #  
       #    ##   ## # #   #    #        #    #    
   ####  #                                     #  
#            #             #          #  #        
            #                        # #          
                            ##              #    #
               #    #              #          #   
          #      #   #   #                       #
        #         #           #       #          #
 #      #      #     #    #        #              
   # ## #         #  #         #       ##   #     
              #    ##          # ## ##            
# #     ##       #      #        #       #   #   #
   # #                  #         # # #       #   
  #       #                    #                # 
                            # #                  #
                           # # #    # ##          
        #    #          #     #   #     #  #  ##  
          #    #           #            #       # 
#    ####     ##            ##       #            
             #  #                #  #   # #   #   
# #           #     ##        # #      #  #       
       #     #         #          #               
   #   #        #    #    ###     #               
                  #    #     #   #                
     #        #   ##               #  ## ##   # # 
  #  #         #    ##      #                     
      # # #       #                    #   #    # 
       #  #                # #  # #         #     
                               #          #       
