            ##    #          # ##         ##     #
 #                     # #     #    #     #       
       #               #            #       ##    
           #          # ##   ##  #  #   #         
 #    #       #   # #                      ## ### 
      #    # #          #   #      # #    #   #   
                    #         #        #   #   #  
  #          #  #            #                    
    # #                        ##         #   #   
        #   #     #                    #   #  # # 
   #      #  ##              ###    #           ##
     #   #             # ## #      #          #   
    ###   #   #   ##   #   #     #    #      ### #
                  #   # #  ##    # #  #           
    #                      #    #               # 
    ## #       ###   #         #    ###     #     
  #  #    #     #      #  # #     #          #    
  # # #            #   #      ###            #    
 #        #      ## #          #          #       
# #    # #        #                            ## 
        #              #      # #  #      ## #    
           #        #                  # #      ##
  ##      #    #   #             ##       #       
     #       #        # #                #        
                          #                       
 #             #     #                            
            #             #        #            # 
    #       ##                       #    #      #
 #   #   #       #  ##                        #   
                                                  
          #         ###        #          ##      
 #              # #          #      ##   #        
                                         # # #  # 
     #       #  ##  #          ##     #      #   #
    #                          # #  #             
  #          ##          #      # #  #      #     
 #     #       # #     #   #        #           # 
     ##   #   #        #   ##  #            #     
#     # # ##   #      #   #        #    # ##      
    #      #     ##         #     #          #    
   #   #  #                        #   #    #     
        #           #      #                #     
   #                #  #  ##              #       
  #   #          #  #    #        #               
    ##  ##  #    #     # # ##  ##                 
  #          #   ##            #   #    ####    # 
   #    ##            # #           #             
 #  ##       #   ###    #              #       #  
     #   #                               #      # 
           #    #  #         #   ##          #    
