        #         #       #       # #   # #       
 #        #           #   ##     #   #            
   # ## ##   #  #          #                 #    
   #        ##        #        #         #     #  
       #           #       #                #     
 #                          # #          #        
             # #            ##  #    #  #  #      
#   # # #    #        #       #                   
     # # ##  #  #           #             ## # #  
               # # #     #   #    #    #   #      
      #  #                 #                #     
          #   #    # #  # #            #   #      
   #     #         ##     #     #           #     
          # #     # #     #  ##                   
   #   #          ##   #  #     #           #  ###
   #      #                        #    #   #     
  #  #          #     #                 #  #      
      ##           #        #         #          #
      #               #          #    #    #    # 
 #    #                       #                   
   #  #                           # #          #  
          #           # ##  ##               # #  
   ##  #        #        # #      ##       #  #   
   #                 #      #     ##              
                  #           #       #           
      #              #    #               #       
        ##        #       #      #                
  #     #   #       #   ###     ##               #
     #               #      #    #          #    #
     ## #                                 ##      
      #   #  #     #     ##   ## #  #            #
       ##    #      #       #   ##     ##  #      
 # #       #      #  #    #                     # 
                #    # #                #    #    
   #  #   # #    ###       #      #  #   #    #   
               ## #  #          ##  #     #       
  #       #                  #          #     #  #
     #   #           #            #    #          
  #                        ##  #      # #  #      
#                   #    #                     #  
 ##    #  #   #         #       #      #    #    #
     #             #       # #     #          #   
                           #     #  #             
#  # #         #    #               #  #         #
     #       #  #                          #      
      # #           #                         #   
                     #        ##   ###        ##  
                              #       ##    #    #
            #                #  ##      #  #      
         #   #     # #  #      #      #       #   
