#   #                            #              # 
 #    #            #     #                 #      
                  # ##   #         # ##           
                   #                #             
   #       #                      #         # #  #
 # #   #            #       ##  #    ###    #   # 
# #      #  #    #              #   #   #         
   # #  #            #      #       #             
   #     #   ## #  #                        #     
   #  ## #          #  #  #  ##      #  #         
                  #       #   #  ##  #          # 
    # ##            #  #                         #
   #              #                  #            
 #  #    # ###         #       # #   #        # # 
#                #                        # #  #  
 #                     # #      #                 
 #        #  ## ####  #      ##          #    #  #
       #        #        #       #                
#    #           #      #  #          #  #       #
# # #    #    #   #  #                    #     # 
#           #        # #            #    ##      #
      #   #            #   #                      
   ##        ## # #            #       ##    ###  
            #  #   #             #       #        
#        # #   #          # #         #           
     #         #                                  
            #        ##                           
      #     #            #      ##   #    #       
  #                 ##    #                  #    
                        # #             #   #     
                #    ### #                  # #   
            #   #  #                   #      # # 
   #      #             #      #                  
       ##   #  #      #    #          #      ##   
   #             #                     #   #      
#           # #     #   # #   ##        #         
 #                 # ##          #            ##  
       #        #   #    #         #          #   
            #           ##        #   #           
         #        #  #  # # # #             #    #
   #                          #    #         #    
   ### #  #        #   #              #     #    #
  ##         #           #        #          #    
    # #     #    #  #                 # #         
#   #  #   # #    #     #         #    # #        
    #     #                # #      #        #  # 
 #       #        #   #            #  #       # # 
                  #        ##     #    # #      ##
    #        #    #        #   # #   ##    #    # 
   #    # #              #         # #  #      #  
