 ##  #     #     #       # ## #               #   
   # #                       #    #  ##   #       
#  #             #               #      #         
 ##     #                        #             # #
  # #     #     #           #     #            # #
   # #        #   #   ##  #      #  #      #   #  
        #         ##   # # #    # #    ##    #    
         #                # #         #    #      
          #   #           #      #                
              #   # #        #            #    # #
           #         #           #   #   ##      #
                 #           #    # #  # # #      
#       #                                   #     
#   #  #                  #   # # #               
         #                       #     #  #       
                               #  # #   ##        
    ##  #    #              #      # #           #
      #         #        ## #      #  #           
 #           ##         #              ## #   ##  
    #            #     # #    ##           ##  #  
                 #   ##   ##                  ## #
             # ##    #  #     #                #  
 #           #     # #         #  #         # #   
       #     ##       #  # #                  #  #
                                               #  
                                                  
#                            #                #  #
         #   #          #             # # ##      
                            # #      ##     #     
    #               #     #               # #     
    #  ##         #   #           #   # #    ##   
    #       ##     #                       #      
   #            #                # #          #  #
                # # #      #      #       #       
   #    ##                 ##  #          #     # 
     # #            ##       ##     #             
   #     #    #      #    #      #           #    
  ## #                      #   #        #        
              #       #   ##          #           
   #                                           ## 
         #        ##        #        ## ##        
  # #                            ###    # #       
       #   # #    #    ##  # ##     #     #   #   
    #   #  #             #         #       #      
     #   #       #        # ##        #     # #   
      #       ##                         #   ##   
      #         #        #  # #    #              
         #    #   #             ##     #  #    ## 
   # #   #    #      #     #       #        #     
#         #  # #  #     #            #     #  #   
