    #       #                  # #   #     #      
 #              #   #                      ##     
     ###         #    #              #      ##   #
  ##       #      ##    #  #      #   #  #        
     #      ###           #          #            
   #                        #         #   #       
    #  # # #      #                    # #       #
 # ##  #   #       #   #  #            # #   # #  
      #    ###        # #              # #    #   
         #                #        ##     # ##    
  #               #       #                  # #  
                #   #      #        # #           
                      ##             #      #     
 #         #        #    #           #         #  
   ##  #   ##                         #  #        
            # #    #    #    #        #      #    
               #        #     ##                  
   #  #    #     ##           #  #   #        #   
  #      #    # #  #    #  #       #   #          
#  #              #  ##  ##             #         
                 #    #              #        #   
            ##         ##         #      #       #
   #     #                            #       #   
        #        #                  #        #  ##
                                 #    ##      #   
                        ##    #                   
                  # #                         #   
      #   # #  #          #        #       #      
# # #    ##             #     #    #      ##   #  
                          #                #      
    #    #          #     #  #       #    #     # 
     #   # ##     #     ##      #       #  #     #
              #   #    #    #       #             
   #    #  #    #      #       # #     #          
#     #         # # #  #   #           #    #  #  
 #   ###         #   #               #            
            #   #            #  # # #             
     #  #  ##    # ##  #           #              
     # #                      #      # # #  #     
    #     #       #         # #   #        #      
         #   #  # #        ###           ##     # 
   ##        #                    # # #       #   
#  #  #       #       # #                      ## 
         ##    #      ##            #   #   #  #  
         #    #  # ##    #          ##     # #    
  #             #  #        #      ## #  # ##     
    ##        #  #             #  ##     #        
  ###                 #    #       #  #   #       
    #     ###      # #  #                #   # #  
    #  # #      #        # # # #     #       # ## 
