       #   #  #  ###    #       #             # # 
           ## #   #     #   #      #          #   
                                       #   #    # 
        #            #   #    ##   #      #   #   
 #  #                #      #    #      #       # 
   #   #    #  #    # #             #   #    #    
      ##    #          #     #    #       #  ##   
         #             #         #     ##        #
#  #  #        #  #       #      # #      #   #   
#  # ##            #    #      #      #           
    #               # ## ## #       #  #      #   
  #                     #    #  #    # #          
    #         #         #     #                #  
      #          #   #         #   #              
      #        ##                      ##     #   
            #   ##   ##    #      #               
  # #                 #          #        #    #  
               ##   #   #                         
        #                  # #       #    #    #  
  #  #                     # # #      #           
 #                #   #      #        #   #       
             #            # #                     
 #  #    #        #                      #        
   #                    #            #       #    
  #    ### #  # #         #  #  #   # #           
      #                  #    #                   
# #            #    #           #    #        #   
     #      #             #                       
 #   #                   #              #         
                    #                            #
 #      #      #          #       ##  #       #  #
         #                               #     #  
           #     # #   ###                 #   #  
 #  #         #       # #    ##       # ##      # 
   #         #         #                #   ##    
#    ##  #        #        #  #     ##   ###      
   #   #  #    # #                    ##  #      #
     #  #  #        ##   # #               # #  # 
                   #   #       #   ##  #          
             ##            #     # #   #          
       #  # #                    #      #         
     #       ##          #  #     #     #  #      
    #         #       #    #     #                
    #         # #      # #               #   #    
 #   #   #  #            #    #      #       # ###
           #         ##       ##       #          
          #     # #    #   ## #  #              # 
      #           #     ###     #        #        
           #    ##      #       #  #              
      #     #      #   #  #        # #    #       
