#         #    #  #     #            #        # # 
                     #              #    #    #   
     #          ##   #       #     #      ##  # # 
                   # # #                   #      
 #                    #             #     #   #   
#        #       #  #   ##     #   #       #   #  
  #         #   #  #   #   #      # #             
#      #                                #    #    
      #   ## # #     # #                        # 
      #     #       #               #     # ##    
  #         #            ##        ##      #     #
    # # #     #  ##          #          # #  # #  
         #     #                  #             # 
              #   #       #                       
          #   #                ##                 
 #            #     ##                    ##    # 
   # #         #                 #        #       
         #  #      #                       #      
 #    #  #  #    ##      #        #      #    #  #
   #   # #    #  #    #                        #  
              #      #  #                         
#   #    #  #        #          ##               #
               #                         #        
  #  #                     #  #     # #  # #      
           #    # #                               
     #    #              #                        
                      #                 #         
 #       #  #  #        #   #               #     
# # #    ##                 #        #        #   
 #  ##   ##                               #       
      #   #         #      #                ## #  
                                                # 
     #  #  #   #              ##        #         
   #    ##                 #                #     
 #     ##           #       #  ###            #   
     #    # # #  #    # #                         
     ###   #           ##                        #
              ##                         #    #   
  ##          #             #    #    #           
  #      #   ## #     #      #                 # #
          #    ##   ##        ##     #    #  #    
                    #             #  #     #      
#        #       #   ###                          
   #  #  #                  #               #     
  # # #     ###   #    #       #     #       #    
        #     #         #  #          #  # #      
    #     #      #  #    #  #            #        
       #               #       ##  #      #   #   
  #          #  #      #        #                 
      ##   ###               #        #     #  #  
