##          #     ###  ##     #     #      ##   # 
   # ##     #  ##     # ##  #  #   #     #   #   #
 #          #  #   #       # # # #           #    
        #   #     #                      #        
     #        #           # #    #        #       
                    # #                 #         
   ## ##   #                      #               
      #  #         # #      #         #      ##   
     #           #      #        ###    #   ##    
  #    # # # #   #                         ##   ##
     #  #  #     #  # #    #  #    #    #    #    
   #            #       # #    # ##     #         
 ##  ##           #           # #           #     
    #    #  #### #     #  #   # #     #     # #   
   #     #          # #                  # # # #  
                        ##    ##  # ##            
##   #         #              #       # #       # 
        # #   ## #                 #    #         
           #      #               ##  #         # 
     #      #      ##      #    # # #             
       #   #        #  ###   ###                  
        #   #            #     #    #    ##       
     #            #  #       #      #    #     #  
      #                       #  #              # 
           #  #                     #         #   
#                                                #
                                               #  
      #                   #     ##   #      #    #
          #             #   #                     
               #                   #             #
   #  #   #                  #   #       # # #    
    ##          # ##  #     #              ##    #
   #        ##              #  #         #        
        ## ##       #      #          #           
       #      #         #               #   #     
#                 # ## # #  #    # #  #    #      
     #       #    #  #   #   #                    
#    ##   #    #  #              #              # 
         #    #              #       #   #        
         #  #   #           # #                   
              #   #  #         #          #       
          #       ### # ##     #     # #   #      
          #  # # #      ##   #      #     #  #  # 
#   # # #            #  #     #                   
   #     #           ##  #   #      #      #     #
#    ## #           #   #          # #    ## #  # 
   #                           #  #          #    
    #  #          #      #       #  ##            
 ###       ##            # #      #   # #       # 
 #            #               #  #      #         
