#  #    #   #  #      # #  #               #    # 
    # #             #  ###     #      #  #    ##  
                 #       #   # ##      #          
                    #           #         ##     #
        #   #         #        #   # #  #         
     #               #  #         ##          #  #
         #           # #        #                 
   #       #   #  # # #  #  #   #    #           #
#        #    #                 ##          #     
##  #  #      #      # #             #      #     
   #  #  #        #           # #          ##     
  # #  ## # #    #     # #          #    #    #  #
     #     #                     ##      #        
                #   #      #         #     #     #
      # #   #  #        ##    #                   
                 #  ##  ## # #        # ##    ## #
##   #       # #  #    # #    ##  #   ##        # 
##    #       #       #  #     #          # ## # #
            #             #   # #             #   
          #  #            #  #   ####             
  #       #  ##      #        # #   #             
     #                        #    ####        # #
                #  #  #                           
    #    ## # ##   #                 #   #   #    
  #    #    # #     #             # #          #  
###                  #  #          #        #     
            #  # #       #       #   #            
      # # #                  ## #           #     
#     #   #             #   #   #                 
  #                           #                   
            #  #      # #            #    #   #   
## #      #                    #      #           
 #      #        # #         # #               #  
       ##      #            # ## #   #   # # #    
    #                   # #   ##  #          ##   
 ##                          #      #     #   #   
                   #     #    #              #   #
         #  ##  #              #   #   #          
                   #     #      #       #         
#                 ##    #         #               
                         #        #     # ##      
   #           #            ####         #        
  #             #   #          #  #      #  #     
          #   #   #    #                        # 
  #    #               #          #            #  
#      ## #        #              #          #    
                   #  #           #   #   #       
           #                           ## #     # 
    # ## #      #   #        #  #      #         #
                   # #    #     # ##    #         
