    #     #          #    #        #   #     #  ##
 #       # #  # #   #           #  ##             
                     #   #      ###        ##   # 
       ##            ##        #    # #           
# # #        # ##     # #                         
#   #      #      #      #  #      ## #  #        
#    #         #                         #        
          #   #         #       #      #          
             #  #       #       # # #    #    #   
      #    #      ##   #           #  #  #        
     #                #                  # #      
#                 #      #     #    ###           
         #           #     #    #        # #      
         ##             #        # # #            
     #     # #   #                         ##     
   #                     #                        
      # #           #       #     #           #  #
         # # #       ##     #      #    ##     #  
  #           ##        ##             #  #     # 
       # # #   #  #            #              ##  
                          #   #    #      #    #  
#        #      ##    # ##     #          # ##    
#         #        #     #      #    # #          
               #    #      #              #      #
  #       # # # #             #               #   
      #              #                            
             #      #   #             #           
  #                   #  #   #       #      #     
 #       #                                 #      
    #     #         #     #        #        #    #
  ## #       #  #       #           #             
      #      #    #  ###    #   #  # # #    #  #  
#                   #    # ##   ## # #       #    
#     #     #   #  #         #                    
#   #              #      #                  ##   
 #  ##       #        ##  #      ##  #            
     #            #    ##     ##       #       #  
                        #  #   #                # 
  #    #  #         ##    #       #        #      
  #  #                        #          #    #  #
     #     # ##     #                   #         
            #               #      #   # #        
 #          #      #     #     #    #           # 
  # #            # # #    #      #      #  #   ## 
##  ##         #   #     #                #       
             ##       ##                #         
         #  #   #    #  #                         
  #    #            #          #   #       #      
   #    #         #     #    #     #       #   ## 
         #            # #        #     #          
