   # # #  #      ##  #  #      #       #          
 #              #      #                          
        #  #   # #  # #      #  # #     #  #      
           #            #   #              #      
      #     #    #                #            # #
  #     #  # #      #      #                #     
   #     ##             ####  #       #       #   
#     #                   # ##        #     # # # 
    # #             #   #       # #    #          
         #  #    #         #   #          ## #    
      ##   #     #    # #    #     #         #    
      ##       #              #              #### 
     #       #                #  #  #            #
     ##     #  #           ## #          #        
       #   #      #    #             #  #         
             #  #     ##      # #       #     #  #
  #            #                       # #      ##
   ##                 #                #    #     
  #                ##                       #     
   #           # #        # # #    #         #    
#              #   ##          #          #  # ## 
   #                                              
         #   #                         #  #    #  
  #       #       #        # #    #    # #     #  
                                        #        #
  #  #                             #              
 #    #  #                #                       
            #           ##              #  #      
    #       #                                     
     #                    #                      #
#     # ##     #              #    #              
     # #             # ##    #    #  #     #   #  
      #        #                  #          #   #
              #     #  #  # #   #  #  #          #
# # #       #    ##                  #            
     # #        #   #                    #   #    
##                    #     #                     
   #    # # #                #       #  #       # 
      #                      ###        ##        
  #        #    ##             #    #       #  #  
       #        #      #           ## # #         
       ##        #  #  ## #     # ##         #    
   ##   #             #         #      # ###      
                               #   ##   #         
            # #      #   ##  #   ##          ###  
             #             ##     #               
   #                    #  #             #        
      #  #  #               #  ###     #    #   ##
   #    #   #       # # #    #  #             #   
  #           #    #       #     # #         #    
