           #   #  # #                             
#    # ##   # # #        #               #  #     
   #   #            #      #   #                  
                     # #         #   # ##      ## 
 #   #                 # #    #                   
#                 #       #             #         
        #     #                 ## #   #          
            #            #    #      #       #  # 
  #             #  ##   #            #   # #      
 #         # #   #       #   #  ## # ##           
    #         #              #           #       #
#     #  #        #  #    #  #           # #   #  
 # #  #  #         #          #    #    #       # 
# #            #     #              #  #  #       
 #     #     # #   #   #           # #            
        ##   ##    #             #            #   
   #         #         #     ##        #   #     #
           #        # #    # ##            #   ## 
      #           #              #     #    #     
     #        #                 #  #          #   
         ##                  ##              ##   
#          # #        #   #       #               
       ##    #             #  ##             #    
           ##                 #   # #             
                                     ## #        #
                         #   #                    
                 #              #    #          ##
#              #     #  ###                       
     #                #  #   ##            ##     
     #   #              #               #        #
 ## #  #     # #             #      # #      #    
  # #    #  #      #         #                    
     #              #                             
                       #             #     #      
#        # #   #     #    ###        #           #
      #   #                      #   #            
        #         #  #              #  # #        
    #    #         # #              #   #         
#  ##      ##  #           #     #                
#            #      #            #    ## #        
            #         #  # #                   # #
                            #      #     ##     # 
 # #           #            ##                 #  
#        #                   #      #           # 
 #    #  ## #  #             ## #                 
               #     #     #  #      #            
 # #        #       ##    # #    #              # 
                         #                 #  ##  
 # #   ##              # #  #      #           #  
#        #     # #   #    #  #     ##   #  # #    
