 #              #   #                    #  #     
       ##           # #   ##  #        #          
 ##   #  # #               #       # #  #         
 # # #                  #            #   #        
 ## #   #                 #   # #   #             
         #   #                    #             # 
               #      #        #  #       #   ##  
 #   #          #    #   ##   ###   #     #  #  # 
 #     #                #   # ###   #  ##         
 ## #       #   #               #    #         # #
   #     #          #     #   # #      #  ###     
#      #       ##        ##                  #    
        # #                  #           #        
   ####                #  #                     # 
   #     #     # #               #     #          
     #      #  #  #               #               
    #      #   #      #    #   #     ##   # # ##  
   ##        #     #                        # #   
  #     #      #      #  #    ###   #   #     #   
   #                #   #     ##   ##             
                #  ##              #        # #   
               #         #     # #    #      #    
   #   #     #     ##        ##  # ## #         # 
    #     ##        #    # ##  # #      # #   #   
                                                  
 #             #                   #      #       
###     #        #      #                         
#                         # #    #    #          #
#         #              #  #   #  #          #   
  #                                               
 ## #       #     #    #                          
                    #           #  #           #  
           #          #          #    # #    #    
  #          #      #      #   #       #   #   #  
  #      #          # #       #     ## #   #  ##  
        ##            #           #           #  #
 #  #             #   #  #        # # #        #  
                      #                   ##      
        #                       #              #  
# #  ##                        #      #          #
              #       #     ##          #         
     ##      #    #     ##     #                  
    # #                    #   #      #  ##       
 #                        #           ##          
                #   #              #          ##  
  #              #         #          #        #  
    # #     #            #                        
#    #         #     #        #   #   #       ##  
      #    #    #  #         # #                  
  #     #           #          #       #     #  # 
