 #    # #  #       #    ##       ## # #         # 
 #   ##  #      #  #       #  #          #      # 
    #    #           #    #            #          
           #      # # ##            #             
      # #      #       #   ##           ###  #    
     #                    #   ##       #        # 
     #       # #        #     #       #           
         #      ##       #      #    #       #   #
 #               #   ##  #   ##          #        
#       ##            #            #      ##   #  
## ##   #  # #          #    # ##      #     #    
     #                  # #    #      ##       #  
                                 #   #    #      #
         #                    #            #      
      # #       #               #         # # #   
   ##  #  #               #            #      #   
# #                 #             # #         # # 
  #   ## #              ## #    # #       #       
      ##   #     #      # #           #       #   
            #                   ##     #   #     #
  #       #       ##    #  # #                    
    #       #                    #       #     #  
        #  # # #                  #               
      ##     #    #         #     #    #    #     
            #                 #   # #          # #
               #    #                             
                         #      #              # #
 #    #   #       #   #   #  #                    
 #           #                          #  # #    
      #              #  # #                       
 # #   #  #          #      ##    ##        # #   
#               #  #     #    ###    #   #     #  
        #         #           #      #  #    # #  
        #    ##  #     #        #     #  #        
        #  #    #       ##    #             #  #  
 #              #    ## #       #            #    
         #      #      # #         #             #
         #   #         #     ##          ##    #  
                            #  #          ##     #
       #      ##        ##  # #        #      #  #
                 ##     # # #      #       #    # 
               #   #     #  #                    #
              #           ##        #    ##       
    #    #    #  #       #                   #   #
#     ##   # #    #     # # #   #        #    #   
            #               #         #    #      
   #         ##   #                 ## #         #
          #    ###              ##  # #           
##             # #  #              #       #      
    #  #               #        #       #   #     
