        #               #         #   #           
    ## ###         # #      # ##     # #          
   #        #     #          #             #      
         ##  #           #         #            ##
           #         #                    #       
          #        #      #        #              
    #          ##  ##         #       #    #      
            ##                    #   #  #        
#        #  #                     #   #       #   
   #    #               #         ##        #     
   # #          # #                  #            
#  #  #   #        #                          #   
##   #  #  #     #    #        #     # #    #     
  #        # #     ###                      #  ## 
 #        #       ##     #         #              
  #             # #          #      #            #
      # #         #      # #          #  ##   #   
                      ##               #          
      #        #                 ##   # #      #  
  #   #  #          #    #   #          #  ##     
        #         # #  #     #     #      #       
      #       #           #         #  #         #
  #       # #             #                  #  ##
#      #      #                  #         #      
                             #                  # 
# #                          #                    
#                 #     #       #  #    #     # # 
 ##         #            #            # #         
#           ##    #  ##                      #    
     #                             #              
       #### #                       #            #
  #    ##    #  # #   #              # #     # #  
##  #                     #         #  #    #   # 
           #              # #        #            
   #     #     #       #       #          #     # 
 # #         #    #                   #      #    
         #  #       # #      #                  # 
 #     #    #  #   #                            # 
      ##      #     # #    #    #  #          #  #
     #                                      ##  # 
#   #  #    #   # #                          #   #
 #          #     #   #  #    # #         #      #
    #     ##   #     #       #         #      ##  
 #     #      # #   #               # #     #     
   # ##   #      #  ##   #                     #  
                    #                  #       ## 
   #       #              #     #   ###           
  #    #          ##              #               
         #       #    #          #                
 #        # #       #                   #         
