 #                 #                      #       
 #      #  # #   #                #      ###  #   
       #            #  #        #    #    #       
        #     #            #                      
 #   #       ##    ##  #   #         #       ##   
                        #    #     #           #  
  #    #          ##         #                    
    #  ##    #  #   #        #          #        #
 #          #    #         #        ##            
    ##       #      #    # #            #   # #   
 #        ###       #            #    #     #     
#      # #           ##    #      #               
#         #                # #      #       #     
  #    #   #             #    ##            #     
 ###               #                      #   #   
##      #     ## #                #  #  #         
        # #       #  # # #      #        #    #  #
          #              ## #     #        #      
   #      #      #       #       #               #
   # #            #     #         # ##         ###
            ##                      #  #      #  #
      ##        ##                   #           #
 #     ##       # #          # #     #       #   #
    #         #    #     #  #         #          #
          #                     ##               #
 #                  #                     #       
         ##      #               #    #           
                                #       #  #      
          #                 #    #          #     
               #     #  #                         
 ##              #            #        #  #     # 
 #  #     #      #    #     #  #                # 
   #     #    #       #         #            #    
   #      #             #       #       #  ###    
         #    #               # #   #         #  #
  #     #            #   #                        
   # ##  #           #         #       #       #  
    #                #  # #  ## #      ##     #   
             #        #        #   #         # ## 
       #       #     #   ##      #       #      # 
           #         # #    #                 #   
#   ##             #         #         #    #     
 ##       #     ##  #     #          #  #         
         ###  #    #  #      #                    
 #              #                     ##    #     
           #   # #                         #   #  
          #  #                 # #  ##            
 #    ##        #                 #        #  # # 
      #   #             #    ### ##  #         #  
  #   ##                     #               #    
