    #          ##     #  # #   #     #   #   #    
                 ###   # #     ##      # #       #
 #  #     #      ##                     #   #     
 #             #              # #    #            
                             #            #       
   # #  #      ##     #               #  #  #    #
#  #          #  # #      #    #         ##       
     #            #   #   #          #   #        
                        #       #              #  
# #  #           #                         #      
        #               # ##   ##   #      # #   #
  ##              #        #        #             
               #  #           #     #    ##       
          #    ##          ###     #   #  ##   #  
                #         ##  ##    ###      ##  #
     ##                       #  #          # # # 
        #    #    #  ## #    #    #          #    
           #                     #  ###          #
             #   #             #                  
     #   # #       #           #    #   #         
#           #    #             #     #       #    
 # ##               #     #     #            #    
  # # #  #   #              #    #                
         #   # ##     #   #      # #   #  #      #
#           #   #                #      #      #  
      #              #  #                         
             #                #  #                
#           #                      #              
                     #             # #    #   #  #
      #   #    #         ##             # #       
  #            #    #              #      #       
      #        #     #                         #  
#           #               ##      #    # #      
      # #      ##      #   #  #  #       #  #    #
      #                  #            ##          
 #  ##    #   # #     #  #             #  #      #
                  ##                #             
#     #          #   #    #      #             ## 
 # # #       #         #      #      #       ##   
#                        #          ##   #     #  
   #              #  #            # #     #       
          #     #     #  ##              #     # #
  #    ##           ####  #           #   #       
  ##     ##         #                             
    # #      #     #     #       # #              
          #  #       #              ##   #    #  #
      #         #                  #        #     
##  #                      ##      #        # #   
#   #            #    #   #                 # #   
      ##    #  #   #              #               
