#     #                           #               
 ###       #    ##    ##            #        #    
       #    #    #    #                ##         
   #        #        #                        #   
              #           #   ##    #    #        
 ###    #            #                      #   # 
    #   #    ##               ##              # # 
#   #                   #   # #       #           
   # ###     #   #  ##   #    # #       #    #    
      ##  #              ##    #   #  ##   #    ##
            #        #    # # #              ##   
   #             #              #  #           #  
          #              #        #           #   
#  # #      #    ## ###  ##  #    #      #        
         # # # #      #       # #      #   ## ##  
     #  #     # #   #    # ##        #          # 
#        #          #          #       ###        
        #   ##                       # #  #     ##
  #                #        ##    #     # #  #   #
  #   # ##          #   #           #     #       
 ###           ##   ###   #        # #  #  #      
   #    # # ##            #                #      
                      # # #                       
   ## #           #    #       #      ## #   ###  
           #                    #    #  #         
 #        #                             #        #
                     #                  #         
             #   #      #             #    #      
  # #          #                   # #    #  #    
##      ##                                #       
            #  #      #            #        #   ##
#              #   ##            #             #  
 #         ##                        #  # #       
 #               ###         ##             #     
  #           # #   #        #            ##      
    #     ##      #    #   #    #                 
#      #          #                        # #    
   #      ###                         ###    #    
  #     #        ##  #        # #              #  
  #   # # #      #   #               #            
              #                        #          
      #               #  ##         #             
# #     ##      #       ##       # #      #    ## 
  #  ##      #      #    #                       #
                       #  #   # ##                
## #  #            #   #       ###               #
#    #  #          #                            # 
   #                    #      # #                
  #   #          #    #               ##     #    
           #        # #   ##            #         
