                       #      #                   
         #                 #      #               
   #    #     #      #              #            #
     # #                 #         #    #         
       #        #              # #    #       #   
   ##   #                    #   #                
       #  #  #    #                #     #    ##  
    #     #                  # #     #            
           #           ##    #       # #   #    # 
 #                          #               #     
         # ##       #    #    #    #    #    ##   
   #       #  ##        #       #  # #     #      
          #     #         #### #        #  #      
 #            #   #    ##      # # #  ##          
 ####          #         #       #        #       
    # #        # #                  #   # #       
##     # #   #  ###       #      # #            # 
   #    ##        ##  #      #  #         #   #   
#                    #  #  #     #          #     
     ##             #           ###  # # ##   #  #
          ##              #        #        #     
  #          # ##                #     #          
        #                                         
        #                      ##             #  #
  #   #    #    # #                     #     ### 
                                          #       
                        #                     ##  
    #               ##          #         #       
        ##                      #  #       #      
 #                       #                ##      
## #   ##   #        ##            #        #     
           #   #    #  #            # #           
 #   #    #   ##     #           #     #  # #  #  
                       #            #       #    #
          #                      # #            # 
    #                 #            #  #       ##  
  ###           #                   #  #          
                 #  #   #  #                      
        #  #     #   ##  #                        
              #  #    #       #  #       #    ##  
   #  #   #    ##  ##          #   #   # #       #
      #     #                       #      #  # # 
  #   #     #        #  #       #        #        
 #    #   # #        #                 # #  #     
       #       #    #    # #     #               #
                  ##           #          ##   #  
    #  #    #      #               #              
## #          ## # #  #     #       #         #   
 #                 #      #  #              #     
      #  #       #       #####   ## #       # #   
