     ##   #     ## #      #      # #       #      
         #          #        #                 #  
   #         # ##       ##                      ##
  #          ##            #    #      #        # 
                             #                    
                             #          #         
 #         # #     #  #        #  #              #
             #  # # #  #                #         
#         #         ##      #       #         #  #
      ##       #  #          #           #       #
                #     #   #                  #    
    #  # #      #   #      #             #  # #   
# #                       # #     #       # #     
  # #      ##                     # #             
 # ##  #             # #   ##    ##    # #        
# #    #   #     #                                
 #                 #  #         #              ## 
  #     #  #        # #            #   #     # #  
##  #   #               #   # #      #    ##      
           #      #                #         #    
   #                #   #   # #     ### #       # 
#   ##       # # # #      #        #         #    
                              # # #         ## #  
            # #                   #           #   
                 #              #                 
 #             #      # #    #                    
  #      #                                  #     
 #                        #  #   #                
         #  #        #   #  #                     
                      #                           
 #     # ##       #   #  # #   # #  #        # #  
# #     ## #        #      ##   #    #   #   #  # 
                #            #  #            #  # 
#                        #                        
    #    #  #        # #                    ##    
      #    # #         #          # #        #    
 ##       #      ##   #        ## #           #  #
  #        #                  #     #        #  # 
    #              #    #               #  #      
 # #             #            # #   #      #   #  
         # #    # ##     ##       #      #    ##  
 ##  ##          # #   #        #             #   
 ##         #         #                   #       
            #   #         #            #          
    ##               #   #         # #     #      
          ##              ##                   #  
      #       #  #    #           ##         #    
    #       #                        #      #    #
            #              ##    ## #   ##        
#  ##              #       #                      
