                        #            #         #  
          #                   #  #   # #  #       
#      #           #  #    # ##     #             
 #   #       #                    #               
                          #          #    # # #   
    #    #               #     #  #               
#  # #       #    #       #      #         #   #  
#              ##                    #        #   
  #       #                                    #  
#           #        #        #            #      
              #              #            #       
     ## #             #                 #         
  ###       #  #          #                  # #  
#      #       #                                  
#     #           #                   #       ####
           # #  #            #            #       
       #     #       #                #        #  
 #             #   #        #   # #        #   ## 
             #   #      #    # #      ###     #   
 #                             #                  
   #     #     # ##  #              #      ##     
#             #  #  ##                           #
#        #       #                                
                               # # #       #  #   
#            ## #                           #     
          #    #            #                     
               #      # # #      #             ## 
 #          #       #                     #       
                              #                   
               #    #                   #         
  #    #         # #            #    ### #        
    #     #    #      ##  #      #     #       #  
        #    #      #         # #            #    
#   # #           #                #              
                                     ##      #    
    #                      #   #          #       
                        #  ##           #    #    
     ## ###   #          #   #          #         
 #     ##  #      #  #       ##   #   #          #
                      # #  #   #  #   #   #       
#         #                  ##   #               
         # #                     #  #       # #   
             #              #           #        #
       #        # #                 #          #  
    #  ##  #                 #   #  #    #        
        #  # #      #            #   #     #  # # 
  #   #  #     #             #  # #     #  #     #
  #     #         #    # #   # #                # 
                       #       ##      #          
#    #  # #        #  #    #                 #    
