#   #                 ###                       # 
         #                        #    #  ##      
# # # # #              #            #           # 
#                 #             ##  # ## #   ##   
   ##         #     ##            ##              
##       #        #               #   ## #        
     ##  #  ##   ##    #      #      #  # #  #    
        #                              #          
                #    #    #  ## #       # #       
    # ##    #                   #  #     # #  #   
  #        #          #                        #  
  #   ## #               #       #    #      ###  
#                         # # ##    #             
   #            # #           # #       #     ## #
         #              #      #   #  ##  #   #   
 #                 #        ## #   #    #         
               # ##        #  #      #   ####     
  #      #                 #         #     #      
    #    #      ##                           # #  
  #          #     #                  #          #
 ##                            #                 #
#    ##        #   #    #   #   ## ##             
# #   #        ##               #  #  #           
   #        #      # #          ##    #      # #  
                #  #           #  #           #   
               #    #                     #       
         #                      #    #      #  #  
          #      #   #                #   #       
 ##      #   # # ##       #  #  ## #      # #     
  #                   #  #                        
   #     #                 #   # ##           #   
                             #                    
    ##   # # #    #     #       #        #      # 
  # #      #    #    #    #                 #  # #
        #          #             ##            #  
#    #              #       #      #    #     #   
#      #    # #                 #        #     ## 
          #             ## #                    # 
  #  #                               #  ## #      
        #  # #   #  # #                           
  #                     #   #          #          
       #      ## #          ###   #      #  #     
 #   #     #       ### #       #  #               
#                  #  ## #    ###  ## #           
       #      #  ## #     #   #     # #           
                      #                #       # #
      #     #             #    #      #        #  
#                    # #         #  ## #    #  #  
          #  ##  #      #        #           #  # 
#      #  #  # #      #     #   #   #  # #    #  #
