        #           # #            #    # ## ##   
#  #    # #       #   #     ##              #     
         # #     #   #    #                  # #  
   #        #       #                #            
       ###  #            #  #        #     # #    
     #  #  #   #          #  #             #      
   ##          #    # ##      ##         #  #     
                 #     #  # ##       ###          
    #   #             ## #                 #      
   #                 ## #        #          #   ##
      #         #      ###    #     #      #      
  #    #  # #             #  #  #  #             #
  #                      #             #          
                   #   #               ##        #
        #   #              #                      
#   #           # #     #   #     #      ##      #
     # #            #   #     #          #        
    # #  #          # #  #   #         #          
##                   # #                # # #     
       #                #       # #  #         #  
            ##        #       ##          #  #    
        ##    #  #    ##    #  #                  
              #                    # #     # ###  
        #   #     #  # ##        #  ##            
#            #    #       #  #     #              
                        ##         #      # #    #
            #    #                 #        # ####
 ##  #    #                 # #    #              
          #           #                           
         #           #                  #         
                # #   #        #     ##           
 ##        # #    # #    ##              #        
  # #  #          ##       ##   #            # #  
  # #       #       #    #     #      #   #  #    
              ##           #                   #  
#       ##    #  # ###            #  #   ##       
 # #  #       #     ##   #     #   #              
       #          # #    #          #            #
              #        #      #       #           
# #               #          # #     #  ## #      
   #   #     ##     #       ## #      #   #    #  
   # #      #               #                #    
             ##                             #     
                    #     #         #  #          
     # #              #              #     #      
  ##   #   #    #  #  ##      #    #  #   ##    # 
   #   #         #    #             #      #      
 #      #    #   #          ##  #     #   #      #
 #       #  #  #    #     #  #    #              #
           #        ##      # #          ### #  # 
