#  #     #                 ## # # #   #           
    #                  # #     #              #  #
# #     #                #      #  #        #     
#            #              #        #    #  #    
          #       ##     ##                    # #
 #                   #  #             #           
 #                      #        #  #         #   
         #               # #   #  # #      #  #   
                 # #   #   #         #    #       
               ##                   ## #       #  
          #    #                   # #      #    #
# #       #                ##     # # #  #        
   # # #        #     ##     ##     #             
       #            #   ##  # #  #          ##    
          #                                 #  ## 
    #    #    ###                  #       #      
# ##  #    #                       #              
 ##      ##                  #      #    #   #   #
               #                         #        
#      #         #  #           #                 
      ##  #  #          ##     #  #               
#            #  #   #                        #    
      # #   #   # # #      #            #         
  # #         #          #  # #   # ## #          
# #      #   #                      #  #          
    ##         #             #                    
        #    # #      #                           
                     #          #  # #    #       
            #  #                            #     
                                                  
           #       #    #     ###        ##       
                                           #      
                #  #      #                    #  
#     #       #     #        # #    #      #   # #
        #     #                       #           
### #     # #  #          #         #         #   
               #             #      #    ###      
         # ##    #   #  #      #          #       
 #       #   # #  #       #                   # # 
#     #           ##   ###  # #      #        #   
          #            ##                 # #     
  # #  ##             ##                          
           #      #   #    ###    #          # #  
    #  #    #                       #             
   #    # # ##   ##       # # #               #   
    ##        #    #      # #  #               ## 
                 ##    #  #             #   #     
           #   #                  #               
      ##      #       #            #       #      
#    ##   #   #            #           #          
