 #  #            #    #   #        # # #          
##  # #            # #  #    # #       #      #  #
 #  #  #                # # #     #   #   #       
  #      #                  ##       ##  #        
      #           #     #          ##  ##     ##  
           #  #           #    ##  #   ##  ##     
  #   #  #  #     #                # #  # #     ##
          #    #          #   #     ##   #    #   
   ##  #          # #   #         # #             
      ###   #     #    #                #     #   
#            #    #   ### #          #            
  # #      #     ## #         # #       #         
              #             #        ##    #    # 
   #           #                           # # #  
                     # ## ###   #                 
         ##     #   #     # #      #              
 ## #         #  #    #   #    #       ##        #
      #     #           #    # #     # #   ## #   
  #              #   #             #      #     ##
             #         #           # #        # # 
                    #       #             #       
 # #       #                 # #                 #
  ##       #                    #     ##      #   
    #  #  # ##    #               #      #        
#     ##       #            #  ##   #         # ##
                                          # #    #
                  #  #  #            ##           
               #                #  #    #         
  #         ## #         #   #  #    ##           
 ##      ##              #         #       #     #
 #                 # #                # # #   # # 
    # ##    #        #            #      #        
 #     #              #      # #    #             
    #     ##   ##         #       #       #       
                      #          #     #     # ## 
       #          ##  #   #        #   #  # #     
  #       #    #     #   #                        
    #  #           ## #                           
#   #          #   #                         #    
           #     #             #    #          #  
 #     #       ##  # ###    #   #      #  # #  #  
#    #                 #                   #      
  #  ##              #            ## ## #    #    
#       #           #     # #   # #               
  #             #    # ##       ###         ##    
                   ##          #   #         #    
# # #        #                          #         
         # # #    #  #                   # # #  ##
 #            # #      #                #     #  #
 #      #      #      #      #          ##    # # 
