##           #    # #  #        #          #      
       #   #     #                     #          
 #        ##  ##  #        #       #         # ## 
   # #           # #       ##     #     # # #     
          #   #  #                                
  #   #  ##                     #                 
#               #               #           #     
    #     #       #          ##       #  #  #    #
   #    #           #  #           # ##           
          #  #             #             ##       
 #             ##    #           #     #          
 ###                              #  #        #   
             #                  #            #    
 #             #          ##                     #
    #                   #  ##      # #          # 
     #     #   # #    ###  #            #    ##   
     # #            ###    #     # #     # ## #   
 #          #     #    #              ##    #     
 #     ##  ##                 #  #   # #     #   #
      #  #      ##        #   # #   ## #        # 
       ##      #         #    #  ##      #        
     #  #       #      # #       ##     #        #
    #               # # #  #        #             
##  # #         #      #     #       #      #     
       #  #         #        #  #       #   #     
               #        #     #                   
#                #    #      ##      #        #   
#                                           #     
    #               #              #           #  
 #                   #                            
       ##                #         #            # 
               #   ##           #    # #      #   
      #  #             #      #                   
              #      ##        #      #       #   
     #      #           #             #           
# #          ##   # #    #              #         
        #             #  #   ## #      ##      #  
  #                      # #     # #      #       
             #   #    #    # #        #          #
    #  ##     #       #      #      #  #     # #  
 #    #                                      #    
             #         #   #   #      #     #     
 #    #                     # #       #   #    #  
      #  #       #  # #       #        #  #       
           #  ##            #         # #      #  
  #                      #  #     #  #  #       # 
    # #        #  # #          # ### # #        # 
#    # # #            #      #        #      ##   
          #           # #       ##      # #    #  
    #   #  #    #   #    ##    #     # #          
