             #               #       #     ##     
 #        #        #       #              #     # 
       #      #         #             #   #       
                #   ## ####          #          # 
                      # #            #  #   ##    
##      #                # #   #      #  # #      
          # #    ##          # #      #    #   # #
      # #        #           #                   #
  #   #   #  #              #    ### #  # #   #   
      #    #    ##        #  #           #  ##    
    ### #   # #   #   ###                         
 #   ##            #    #     #  #  # #         # 
     ## #         #  #         # ###### #   #   # 
                              #           # ##    
    #                    #  #               #     
              #     #  #  # #               #    #
#     #   #       #   #   #   #      # # #        
  #      # ##  #                              #   
# #  #          #        #                        
               # #   # # #    ## ## #       #     
   ##     #   #  #         ###   ##     # #       
  ##    #       #          ##    #     #      ##  
         #      #               #   #           # 
           #     #    #   # #     #           #   
        ##      #                               # 
  #                      #   #     #    #         
                    #        ##    #            # 
     #  #      #                                  
            #         #   #        #         #    
 #                                        # #     
#  #       #          #              ##           
  #      #       #              # ##    #         
       #    #                     #      #     #  
   #   ##          #      #                       
       #        #    #              #          #  
##      ##           #    #    #     # #          
          #      ##  #  # ##  #      #  ## ##   # 
#      #            #  #    #      #     #        
   #  ##  #       #   #              #  #         
      ## #       #  #       #      #        #    #
   #           #         #      ##   #       #    
## #           #                     #    #       
                 #   ##       #   # ##          # 
   #          #  #      #                   ##   #
  #   #                #                  #  #  # 
  ##         #  #                    #          # 
  #   ##  #  #   #      #        #      #  #      
  #     #      #    ##       #  #    #          # 
  #                        #  ##       #   #  #   
 #          #     #  #            ##  # #        #
