 #             #                #     #         # 
               #    ##   #      ##                
    #       #    #    #   #  #  # #   ##  ##  ##  
 ##   # #    #   ##        #           #  #       
     ##  #             #   # # #    #       #     
#  ##   #     #   #   #      #              #  #  
     #               ## ##              # ##      
  #   #  ## #        #    #          #       #    
        #                   #      #   ##  #     #
             # #    #        #         #    # #   
     # #         #    #       #  # #      #       
     #   #  #    ##           # ##    #        #  
#                    #    #             #         
  #     #              #     #   #           #  ##
 ##                #            #         #       
 #         ##                #        # #         
          #    #                         #     ## 
                       # #    ##   #  #   ##      
 #                      # #     #  ##             
#    #      ##     #  # #    ##               #   
##  #    #      #    # # #                        
     #                    #  #    #    ##         
 #       #    #           #      #    ##    #  #  
    #           #    #   #        #    #       #  
# #           ##                 #               #
                         #    #                   
                  #                              #
            ##    # ##   #           #      #     
                  # # # #             #           
      #             #     #        #              
      #     #                # #       #      #  #
            #               #     #     #       ##
                        #                 #       
    #       #    #   #            #          #   #
         #  # #  #       #    #             #     
    ##       #  #        ##               ##      
                     #    # #           #     #   
         #         ##  #      #         # ###    #
             ##    #        # #              #    
  ##  ##      #  #        #  #     #              
     #          #              #    #    # #      
   #            #  #                ##     ###    
                 ##      #          # #    #  #   
 #     #  #   #    #     #          #             
#      # #    # # #  ##    #     ##     # #       
               #     #       #        # #   #     
      #   #   #            #   #   #   ##  #    # 
#   #  #  #  #             #                      
                 #      #             # #         
              #                        #     ##   
