 ## ##                     #   ##  #              
         #   #               #            #       
      #   ##   #    #  #     #   # # #     #     #
  #       #                       #         # #   
           #    #           #  #              #   
            # #                           #       
  #       #            #  # #    # # #            
      #     #                    #                
                                   #            # 
  #     #         #    #         ####  #   #      
       #         #    # #          #     #    ##  
    #   #   ##                         #    #     
                     #  #               #  #   #  
    #    #     #  ##  # #      #                  
  ##               # #           #     ###        
 #       #     #       #   #                #   # 
 #                 #                 ##         # 
                           #      #    #          
     # #      #  #       # #  # #   # #      #    
  #           #  ##      ##      #  #          #  
##         #   #        # #    #            # #   
#                    #       # #  #      ##     # 
                             ###      #     #     
                        #               #    #  # 
#         #         #       #               #     
 #        #         #              #    #        #
 #    #  #           #      #                     
 #          #                                     
#       ##        #                         #     
     #         #                                  
                            #                     
                  #  ###  #                    #  
   #                 #              #        #    
            #                ##   #        #      
       #    #       # #          # # #  #   #   # 
      #       #         #        #           ## # 
                          ##    ##    #           
#      #  #       #   #                  ##       
         #          ##      #         #      #    
   #               #            #   #   #   #     
  #             #            ##   #  ##           
 #              # ##      #         #             
 #                 #           #              # ##
 #    #     # #       #        #     #            
    ##                       #     #   #         #
       #   #       #               #      #      #
         #      #  #    #     #   #  #            
#  #     #        #             ##                
# ## #             #                ##  #         
  ##         #        #   #    # #        # #    #
