    #        # #      #              #         #  
   ##                             #  #            
   #             ##   # #    #     #  #   # #   # 
              ###   # #  #        #      #  #     
                  ##        #           #     #   
         #    #                  #  #     #       
       #  #    #     #       #    #        ##     
            ##              #       # #  # #      
   #   #            #       # #               ### 
 ##     ## #     #       #  #        #          # 
    ###  ##          #  #                         
           #     #  #      ## #            #   #  
 #  #    ###   # #     #  #  #       ##       ## #
  #  #    # #                           ##        
   #  #          #  #      ##                #    
# #  # #      # #   #   #                         
 #      #        #   ### ##                     # 
                   ##   #   #  #     #  #         
               #  #                #    ##        
   #        ##   #                 #      #  # #  
#          #       #    ##           #      #  #  
         #                  #      #        ##  ##
           #            #     ##           # # #  
    #     #  #  #                           ##    
#          #                          #      #    
                              #         #        #
            #                    #   #  #         
      #                         ##   #  #  #      
      # #         #       # ###    #          #   
                      # #          #              
     #     # #    #    #        #            #    
     #        #  #    #  #                    ## #
         #                     #          #      #
 #        #         #     #            #    #     
  ##          #      #  #    # #        #    #  # 
  #                     ## #               #      
      # ## #   #           #     #          ## #  
                        #           #         #   
    #   #      #   #  #        # #          #     
#  ##  ##                      #   #             #
   #                  #          #           ##   
  #      #        #  #           ##      ##       
     #    #                 #         #         # 
      # ##         # #      #       #      #      
   #       ##    ##       #           #         # 
        #      #                #  ##     #       
       #   #   #      # # #  ##     #       #     
 #     #   ##      #       #  ###        #   #    
 #            #     #                           # 
     #       #            #              #  #     
