                 # #             # # #   #      ##
           #            #    #      #            #
  #  #     #             #    # ##      #     #   
  ##               #  #    #      #       #   #   
    # ##            #        #  #  # #      #     
            #                   # #     #         
#    #        ##      #             #    #  #     
   #  #        # #          #   #          #      
 #        #   #           # # #  ##             ##
    #          #  #  #  # #  #    #      # # #    
       #               ##      #         #    ##  
       #      #   #       # #  #         #     ## 
 #        #            # #                       #
 #    #    # #    # #  #                       ## 
              #      #   #    #                   
 ##  #   ##         #          #      # #         
        #         ##        #  # # #      ##      
    # #                #     ###     #            
    #  ##   #        ###    #   #    #    ###     
    #        # #                   #    ##        
            #            ##                  #  # 
           # #     # #     # #   #   #  #         
                 #            #           ###   ##
 #         #         #                         #  
#       # ##                 #  #       #         
                                            #     
  #                 ##  #    #        #           
### ##      #    #        #                       
#   #   #           #         #                   
 #   #                    #                       
      #        #  #  #                   #   # # #
  #        #        #      #  #             #     
   #                  # # #          #      #    #
 #       #       #                     #         #
  # #   # #      #       #                   ##  #
     #    ##               #              #   #   
  #        #                     #    #     #  #  
#          ##            ####         ## #    #   
 # #      ##          #    #               # #    
   # #          #       #   ##   #          # #   
          #    #                    #       #     
 #                  #                        #    
  #       #               ##   #     #           #
       #     #  #          #     #       #        
       #                    #   #                 
              #      #      #     #   ##     #  # 
  #                  #   #       #     ##     # # 
   ## #        ##  # ##   #    #     #   #        
#    #                                 ##       # 
#          ##           #                       # 
