                                 #### # #   # #  #
                # # # # # #  #               # #  
   # # ##   # #      #   #      #           #  #  
#   #     # #  ## #         # #        #          
           ##       ##       #    ##  ###       # 
           ##  #         #    # #      #          
#  # # ##               #     ## #     #     #   #
    #        ##       #            #   ## # #    #
       #           # #     #    ##  #             
        #        #        #                #      
                     #  ##        #    #          
 #        #    #        #    #     #   #    #     
###    #     #                           # ##     
 #     #        #    #                    # #    #
  #    #   #   #      #        #   # #            
                       #   #   #  #   #           
         #   # #  #       #    #                # 
             # # #                     ##         
                       #            #         # # 
      ##   #        # ##  #  #  #                 
              #     #                         #   
 # ##            #         #               #  #   
 ##           # ##       #       #   ##  #   #    
       #   ##  #       #       #      ##         #
       ##      #    #       #                     
     #                       #                   #
                    #         #         #     #   
 #                #           # #                 
    ##    #    #                             #    
    #                                     #       
#                  #               ##      #   # #
     #  #       #           #                 #   
#   #       #    #        #        #              
 # #        #   ##                        #      #
#  # #    #  #               # #    # #           
#    #            #          #               #    
    #      #       ##        #    #               
            ## #    # #        #                  
      #           # #       #        #            
  ##  #    # #    #                  #            
#                ##       #   ##         #   #  # 
  #  #        #  ##                 # #           
   #  ##              #        # #    # ##   #  # 
     #   #       #     #              # #         
#      #  #   #  #   ## # # #               #    #
 #   #      #  ## # #    #   # #              ##  
  #   #  # # #    #      #      #        # ## # # 
        #   # #  #          #                     
     ##      #                   #               #
        ##     #        #         ##     ##       
