     #    #  #                              # ##  
        ##      #  # ##     ## #            #     
       #    #  #   #     # #        #             
    #           #  #  #    #  #    #         ##   
      #     ##      #                  #          
#     ##    ###        ##                         
      ##                        #   #             
         #  #     #          #              #     
   #    #                 # #   ###         #     
  #      #         #   ## #        #   #       #  
          #     ##                    # #         
                 #        #            #     #   #
      #                                       # ##
      #   ###       #  #       #  #         #    #
                #    ##                  #        
# #                   #            #          #  #
   #       # #                                  # 
          #  # #  # #    ##                       
                       #    #                     
     # ##  #               #        #            #
 # # #                    #          #  #  #      
    #       #     #   # #      #    #      #      
# #     ###                # #               #    
#  # #      #          #         #                
#        #                  #     #           #  #
  #   #        #          #                       
             #                                #   
      #      #      #                             
                    #                       # #   
      #                                 #        #
                #       #      #           #      
                    #                        #    
              #   #         #            ##    #  
   # #          # #   # #       #    #    #       
 #      #            #   #      ##                
      #     # #                        ###  #   ##
                     #     #        # #           
 ##    # ###       ##       #  ## #               
  #          ##  # #     #     ## ##             #
       # #           ##  #   # # #                
    ##   ## #            #    #               #  #
 #        ## #                       #   # #  #   
   #      #                     #    # # #  #   # 
#      #                      #         #  #      
                    #  #     #    #   #        #  
   #     #         #      #      #          #     
    #     #     #   # #          #           #  ##
                  #       #  #      #    #        
#    # #  #    #                    #             
    #   #   #                   #               # 
