 #  #    #  #           #   #   #             #   
    #     #  #  #   #      #        ##   #        
                     # #         ##   #           
   # ##  #     #             #   # ##           # 
#     #   #   #       ##    #           ##    #   
    #             #             #    # #   #   ## 
  #           #     #     ##              ##    # 
 ##      #    #          ##  # ##         #      #
  #       #       #              # # #     #   #  
#      #      ##     #             ####      # # #
  #             #   # #   #            #          
    #                 ###    #                # # 
   #     #                    #                   
   #         #  ####                        #     
             # ####    #                #         
 #       # #         #            #            #  
     #                                            
    ##       #    #    #      #   #               
     #         ###              #               # 
#          #          #    #   #              #  #
     ##               ### #   #    # #            
    #            #                    # #         
        # # #     #  #  #    #                    
   #    ##  #   #                     ##    ##    
           ##   ##  #         #  #   #        #   
               #      #                          #
         #                                       #
        #    #   #           #  #       #         
 #  #   # #         #                         #   
                         #         #             #
#            ##       # #            #           #
 ##          #           #          #      #   #  
       #            #             #               
# #             #      #     #    #           #   
       #  #  #                 #  #       #    #  
    #           #           #         #   ####    
   #                       #     #             #  
   #  #     #       #  #      #                   
                     # #       #                  
     #    ##        ##     #        #    # #     #
     #    #  # #            #   #            #    
            #   #      #            ## #     #    
  ##          # #           #       #     #  #    
    #   #   #  #      #                         # 
         #  #   #    #     #  #     #    #   #    
  ## #  ##    #             #    #    # ###    ###
                    ## #        #               # 
  # # # ## #    #        #  ##     #              
     #                      #  ## #    #       #  
         ##          ##   #          #      #     
