   ## #               #     #               ##    
     #                          ###  #       #    
                                  #           # # 
   # # #    # #   ##       #     ##               
        #         # #                # #          
     #          #       #     #     ##          # 
     #     #   #              #       #   #  #   #
 #    #              #   #      #    # #  #   #   
# #    #     #   ## #                             
          ##  #                #      #  #        
 #          # # #      #    #            # # #    
          #                               #   #   
 #       #  #    #     #   #   #  #      ##       
#   #   #   #                       ## #          
    #     #               # # # #  #   #       #  
  #        #            #    #    #    #      #  #
                  ##  #  # #  #       #   #    #  
              #        #                 #   # #  
         ##      #  #  #    #   #     #       ##  
 #    #           #       #    #   #  #           
  #             #        #      #     #      #  # 
        ###        #           #  #   #          #
  #        #   #                         #    #   
#        # #                 #   #                
#        #    #     #       # #              #  # 
 #             #                            #    #
          #    #    #                   #         
      #   #       #         #             #       
 #        #      #          #           #  #  #   
 #                            #           #       
              ##    # #        #                  
         #              #               #    #  # 
  ##    #     #                 #   ## #       #  
                                  #         ##  # 
               #      #    #   #               #  
     #    #           #      #  #       ##   #    
         # ##      #      #           #  #     #  
#         #            #                        # 
           # ##   ##      #          #            
   ##                 ##   #    #    #      #  #  
  #    #       ## #      ##       #  #          # 
        #   ##      #   #             #       #  #
                      #      ###       # #      # 
# # #    #     #          #            #          
   #          #    #                  #  #   #   #
           # #                                 ## 
##  #                          #   # #      ##    
#  #     #                  ##            #      #
            #           #             #        #  
                 #                       ##      #
