             #             #   #     #         ## 
            #        #  #  #      ###      #      
     #  ##                             #       # #
               #   #                #             
                  # #     # #     # #           # 
      ####  #  ##  # ##     #          # #    #   
  #     #     #      #   #     #      #    #      
               #    #        ##  #        #       
    ##  #  #            # #        #   #         #
# #   #         #  #  # #          #  #   # #   # 
 #  #        #  #            #    #     #     ##  
    #             ##         #   #      ##        
   #  #         ##             #   #  # #         
         #    #   #                # #     #      
 #      #            #     #       # #  # #       
             #         #   #       #         #  # 
   #   #  #    #        #         # #             
              #                         #         
      #            #     # #      ##  #           
        ## #      #     ##  #                #  # 
  ##   #            #       # ##                  
      #          #           #                  # 
            ##            #            #     # #  
#     #  #   #        #      #       #  #         
       #    ##                              #  # #
  #       #         # # #                   #    #
 #                #   #      #     #  #           
 #                      #        #                
#       #               #       #         ##  ##  
                    #                             
    ##   #                    #     #   #  #  #   
     ## # #     #     #  #                    #   
        #     #        #         # # #           #
        ## #           ##                 ##      
    #        #        ##         #      #  # #    
             #    ##       #   # #  #    #  #   # 
             #   ##   #   #   #    #          #   
   #      ##             #         #   #  #       
 #  #                 #    #        #             
   #   #      #      #        #          #  ##   #
              #      #          #      #          
       #  #      #           # ###        #   # # 
  #       #        #       #          #   #       
          # #    #                   #   #  #     
 #    #     #       #  #  ##       #       #  # # 
               #         #       #    #    #      
                #        #        #   # #   #  #  
                   # #    #            ##         
#                         #    #                  
           #      # #    #         #        #     
