  #        #  #    # #      #   #           #   ##
 #   #    #              #            ##      #   
       #          #          #       #       #  # 
        #                #      #    ##           
             #          #  #  # ##          #     
    #          #       ##      #                  
    #        #        #          #            #   
#     #          #         #                      
  #        ##  #      #           #  #  #    #    
      #       #       # #    # #    #             
   #    #    #    #   #              ##           
             #       #      #                     
 # #  #     #    #     #  #                 ###   
# # #   #         #     # ##                    # 
     #   # #   ##     #   #                      #
       #   #  #     # ##                #         
     ##                   ##         #      #  # #
            #   #   #  #  ##  #           # #    #
             ##                     #             
                       # #  #                     
 # #              ###      #                   #  
    #       #        #                    #       
              #                 # #   #           
#          ##         #  #   ##                   
         #                #    #   #  #        #  
          #    #                                 #
                    #                             
    #                   #                         
 #        #    #             #   #         #      
#                        #                ##      
                       #  #            #          
                              #       ##      #   
                    # #    #         # ##  #      
       #      # ##     #      #       #   #   ##  
          # #         ##            # ##  #  #    
     #    # #  #    #          #    ##   ##       
         # #         #     #     #  # #   #    #  
          ## #                   #    #     ##    
 #       #   #     #                            ##
     ##       #        #    #   #     #        #  
 # #           #                       #   #      
         ##   ###    ##  #  #     #               
###     # #    #  #  #   #       #              # 
       #       ##              #              # # 
     #   #   #                      # # #  #  #   
#                   #           #                 
          # ##   ## #   #                ##     # 
              #    ##  # #                #   #   
     ##     #  ##           #                  #  
                    ##                   #       #
