    #                 #     ##       #           #
   #     #    #           #    #        #         
                   # #       #   ## #    #        
    #                    #          #  # #       #
    # #                      #    #    #  #  #    
 #    #                #  ##              #       
   ## # ## #  #  #       #              #         
   #             #        #         #   #   #     
#  # #         #     # #     ##         #   #    #
  #         #    #     #                     #    
     #     #      #   #    ##      # #            
     #  ##     ##       # # #                     
      # #   #             #          # ## #       
   #     #        #           #             ##    
 #     #             #                      #     
##      #                      #        #         
 #     #      #    # #   # # #   #  ##  #     #   
            #   ##       ##    ###   #     # ##   
 #    #         # #    #      #      #           #
     #    #          #  # # ## ##            ##   
    # #           # # #              #   #    #  #
   #   #         #  # #     #              #    # 
      #                  ##    #                  
#  #  #        #  #  # #    #                #    
                                     #      #     
 ##                                              #
         #                  ###             # #   
                                          # #     
            #                #                    
                     #                            
                    ###   #                      #
 #  # #     # #          #  ##  #  ##     # # # # 
      #                            #     #       #
             #         #       #   #          #   
     # ### #     #  # ###  #       #     # #      
         #  ##   #           #                    
            #     #    #              #   #  #   #
     ## #       #  #   #          #      #        
      # #                #  #   #            #  # 
#       #                    ##          #   ##  #
#     ###          ## # #  #      #               
   #    # #        #    ##   #               #    
        #                #              #       ##
  ##   #      #                  #               #
  #           #    #   #        #      #  #       
  #      # #                    #     #           
         #        # #         #        #    ###   
                ##  #                 # #         
  #        ## #          ##   #           # #     
#    #                             # #         #  
