       # #                          #    #     #  
#    ###     # #                      #    #      
               #     #           ##    #   #  # ##
                      #        #  #               
                     #           #       #   #   #
    #  #      #   ##  #  #         ##    #  # #   
   #        #    #      #       #                 
  ##     #   #          #               # ##      
  #   #       #       #    #   #       #   #   #  
           #   #           #    #  #              
         #      #            #    # #        # #  
    #  ##           ##          #             #   
             #         #        #  ###            
              #     #   # #              #  #   # 
     ## ###      #    # #       #           ##    
      #            ##         #                 ##
  #  #      #    #            ## ##    # #     #  
          #       #    #        # # #             
      ##   ##     #  # #            #      #     #
                     ##        ##           #     
                 #     ##    #  #            ## ##
   # #        #   #            ##   ##            
    #   #      #               #            ##    
     ###     #              #            #   ##  #
  #                 #                             
#                            #     #              
 #           #          #            #         # #
                                        #         
               #     #      #                # # #
#       # #           #   #               # #     
 #           ##          # #  #      #            
         #  #  #       #    # #  # #    ###      #
 #        #                     #               # 
    #      ##    ##       ###                  #  
 #    ## #    #     #    #       #   #       #    
 #          # ####                    #     #   # 
      ##         #                    #        #  
           #     #       ##         #    #       #
#                                      ##   #    #
              #       #              #            
 #         #        # ###        #             #  
       #     ##  #             ##   #   #   #     
#  # #              ####                       #  
     #      #  #      ##     #    ##  #           
  #             #    # #     #        # ####  #   
            #      #                       #   #  
     #                          #                 
#       #           #   ###        ##          #  
                                   ### ##     #   
    ##           # #          ##                  
