  ##  #    # #    ##        ###  #    #           
       #        # #        #         #  ##       #
       #     #    ##           #      #     #   # 
 #    #  #       #  #  #        #    #   #      # 
      #                #     #     #            ##
 #  ##     ## #         #    #   ##    #          
  #   #          # #  #                           
        # #     #  #                    #      # #
       #   # ###   #          #  ##          #    
     # ##        #   #                # #        #
#      #    # #                #    # #           
  #                   #    #                 ##   
        #   # ##        # #        #            # 
  # #       #   # #              #                
     #       ##         #      #     #    #     ##
      #                 #        #          #     
     #  #             #   #   #                 ##
       #  #     #          #   ##  #   #          
 #           #   #  #       #             # #   ##
#      #        #                ##  # #      # # 
       #        #          #           ##      ## 
    #      #     #         #      #   # ###   #   
     ##         ##         ##      # #       #    
#      #                    ##   #      #  ###    
       #           #                          ##  
 #   #              #       # #                   
      #     #  #                ##                
                 #    #          # #  #           
 #   #                       ##            #      
      #                                           
 #     #       #           #  #   #               
               #        # # ###        #       #  
  #            #     #                     #   #  
        #     ##            #  #   #   #          
      # ##  #       #  ##     #  ##   #           
   # #     ##     #    #  ##      ##      ## #    
#       #           #  # # #      #      #     ## 
       #     #      #        #   # #       #  #   
    #        #     #  # #       # #  # # #  ## #  
            #    #  #    #         # #       #    
      #         ##    #         # #    #     #    
#        #                 #        # #  #  #  #  
     #     #       # #        #        # #  #   # 
 #       #      #   ##                            
#     #          #    # #      #     #            
                #      #   #   #         #        
    #    #        #  #  #        #            #   
 #    #   #         # #  #      #       #         
          #    #      #               #       #   
   #  #                        ##    #   #        
