 #  #             # #           ## # #          # 
            #                   #        #     # #
            #      # #      #             ##     #
    #      #      ##  #        #           # ##   
          # #   #      ## #  #     #    #         
            #    #   #    #   #      ##      # #  
   ###                 #      #  #                
   #          # #                     #  #       #
            #       # ##           # #      ##    
       #   #  ##           ##           #     #   
       #      ##       # #                   #    
 #              #    #  ## # ##   #  #  #    #   #
                     #            #            #  
            #           #    #      #             
#                #                     # #        
           #              #   #                   
 #     #    #           #  #  #       ##  #  #   #
  #                      #   # #  #        ##   # 
             # #            #   #   #           # 
 #    #  #        #  #      #               #     
    #         #              #   #                
##    #              #        #        #   #    # 
     ###              # #  #  ##   # #  #         
 #         ###        #    ##  #   ##     #   ### 
 #            #             #        #      #     
          #              #                        
 #      #      #         #                        
  #                                         #     
                  #     #               #     #   
      #                 #                         
  #                     #      #          #   #   
            #  #          #                       
        ##      #      ##   # #                 # 
   #  #  #   ##    ## # #       #  #              
           #             #         #     #        
  ## # #             ##       #             #    #
                      #  # #  # #       #         
         #             #    ##      #  ##  #  ##  
   #    ##      #       #                    #  ##
               #  #        #   #   #              
                #           #                    #
 #  #    #           #      #   # ##      ##      
# ##  #     ##          #  #            ##   #    
#             #            #     ## #        #    
  #          #            #                       
          # #  #          # #        #            
#              #   #  #    #                      
#    # ##  #     #  ##         #                  
 # #       #   # #         #             #    #   
 #      #       #          #           #     #    
