 ##   #         ###  #  #              ##     # # 
      #   #  #               #     #              
 #       #      #    #           ###     #  #  #  
#                #    #                     #     
        ##   #     # #             ##     #   #   
  #    # # #        #  #  #                    ## 
#    #       # #              ##                  
  #         #      ###              #    #     #  
                 #  #        #      ##   ## #     
  #               #             #              #  
   # #     #       # ##  ###   # #              # 
      #    ##  #                                  
   #   # #    #   #                       #       
   ##  #  #            # #                   #    
   #   #                        #           #     
# #       ##        #     #      #    #       #   
                #      ##      #   #     ##       
         #  #     #      #  #  #  #        ##     
     ## #    #       #     ##     # #       #  ## 
            #   ##    #                        #  
   #              #                     #         
#   #                        #  #      #          
   #      #             #    #    #  #    # #     
   #        ##      #              ##      #      
           #   #                      #     ### # 
      #               #      #          #         
         #           ## #        #   #         ## 
    #     #         #   #        #   ##           
 #        #    # #              #          # #    
#   #          #    # #  #                        
#                    #           #    #           
     #                  #        # ####    # #   #
 #           #    # #   #  #          #           
     #                     #        #     #   #   
#           # #    #        #    #         # # #  
         #      #            #       ##      #    
   #  #         # #          #   #            #  #
                 ##                   #    #     #
             # #              #     #      #   #  
     # #    #            # #  #       #      #   #
   #      #       #                 # #         # 
                #  #     #  #              # #    
  #       #    #      #  #  #      #          ##  
     #  #        #         # ##    #   # ##     # 
      #   # #          #                          
        #  ## #            #   ##              #  
## #      #           #     #   #         # #   # 
     #       #       # #   # ## # ###             
  #                 #  ##  #        #     ###     
           ##           #        #                
