        #   #   #                   # #           
  #                       #    #    #   #   #   # 
           ### #   #   #   #           #   # #    
             #  #    #    # #            ##       
                # #  ### #       #            #   
     #   #    ##     #      #   #      #        # 
 #      # # ##         #     #           #  #     
  # #    ###   #          #        #           #  
          #   #  #      #       #       #         
      #  #              #  # ##    #              
                            ##    #    #  #  #    
 #    ##  #            #     #     #         #    
    #             #           #      ###  #       
## #                ##            ##   #        # 
                  #  #   #                     # #
        #      #  #  #      #  #    #    #  #   # 
           # #      #    ##   #         #    #  # 
      #                         #     #           
 # #    #      ##      # #     #   #     #  #     
           #  #  ##     #   #      #            # 
               #   ##      #       #  ##       # #
          #   #   # #    ###  #                   
            #  #    #  # #         #    #         
# #      #   ## #   #    #    #     #             
          #     ## #         #  #                 
               #              #                   
                          #           #           
                  #                #             #
##      #                 #               #      #
 #   #                                            
  #  ##       #    #                        ##    
          #                           #    #    # 
     #   #           #               #   ###      
#          #            # #       #        #  #   
       # #   #  ##   #  #          #       ##   # 
       # #         #         #        ##      #   
   ## #  #                             #          
               ##     #   #      #  #        #    
#     #   #        #  #         #                 
# #             #   # ##           #         #    
  #    #        #  #        #      #        #     
            #  #         #                #      #
          # ##          #                         
   #     #                       #  #     ## #    
 ###          #     ##     #     # #  ##  ##  ##  
     ###  #                           #   ##      
#    #      #                 #             #     
  #   #            #    #     #       #    #      
## #   #           #             #                
#                 #    #        #        #    # # 
