             # #                ##        #       
   #       #     #                     ##        #
   # #                      #      #        #  ## 
         #               #     #    #  ##     # ##
              #    # #     #         #  ##   # #  
#                    #    #  #           #       #
     # #        #  # #                      ##    
         #    #        #         ###     #   # #  
  #  # #            ##          #         ##   #  
              #             # #  #     #     #    
 #           #            #              #       #
#            #     #       ##             #       
     #             #          ####        ## #    
             #       #   #     #    #  #      #   
#         # #  #    #               #    #        
         #                 ##    ##    #          
  #      #    #       #                          #
        ##   #          #        #              # 
            #             # #   ##  #             
 #            #   # #   #        #           ##   
     #      #     # #        ##        #    #     
#        #      #    ###       #              #   
 #    ## #   #           #    #      # #  #   #   
     #                        #      #    # #    #
           #                 #   #           ##   
     #                                      #     
             # #            #               # ##  
         #       #               #      #   #     
#                 #                  #      #  # #
    #   ##               ##   #                   
         #                #         #    #       #
              #  ##         #   #       #         
    ##         # #        #   #                   
#  #  ##        # #                           #  #
   #   ##                  #    #      #     #    
           #  # #                     #           
   #    # #               #    #         #      # 
                # #    #            #        #   #
#                       #         #       #    # #
          #     #           #    # #              
     #             #                      ##  #   
  #   ##      #    #      # #              #      
         # # #  #     #  #  ##       ####  #  # # 
   #    #   #       #                    #        
   # # # #   #   #           # #  #            ## 
    #     #                      ##               
  #            # #       #   #        #       #   
             #        ##  #                 #  #  
           #     #         #   #    #         # # 
 #    ##    #       #       # #             #     
