# #                     #     #     #             
 #    ##     ##           ## #                  # 
        #                    #             #      
         # #    #         #       # ##     #     #
       #          # ##                            
    #        #            #      #    #           
        #         #   #           ##      #  #    
       #     #  # #   #   #   ##  #               
        #     #     #         #  # #   #         #
  ##  #          ##       #  #     # #            
                       # #    #   #   #           
    #                           #         #   # # 
 #  #      #   #        #    # #   #    #         
  #           #                 ###     # #       
                             #          #   #   # 
  #    ## #  #         #    #      #        #     
             # #    ##  #                        #
         # #          #      #     #              
# ###           ###  #   #  # #          #       #
# # #   #       #          #      #   #     #     
#                          #     ##               
    #   #   #     # #      #    #             #   
 #       #              #   ####             #    
    #   ##   #     #       #      #       ##   #  
                          #        # #      #     
                     #  #                   #     
            #  #  #  #        #         #     #   
                  #  #  # #   #  #    #   #       
# #  #         # #    #      #       ##          #
    #                   #               # # #    #
               #     #      # ##    # #           
       # #    #        #       #        #   #     
  # ##                # #  ##    ## ##            
      #     ##                #    #  #    ##   # 
           #         #     #              #     # 
##  ##                                     ##     
        #           #   #               #  #      
  #   #    #     #    #  #          #   # #       
     #   #     # #                #     #  #      
          #   # # #     #                     ##  
             #       #            ##        #   # 
#    ##           ##   #  #     ##          #    #
            ##   # #    ##     # # #   #  #    #  
    #    #      #                #         #      
      # #    #  # #    #         ##    #      #   
            ##                #   #   #  #        
 # ##    ###     #         #                      
  #      # ##  #              ##       #          
          #                    #   #            # 
       #          #     ###  #                    
