                # # #  ##  ##         ##    #   # 
 #     #             #  #              #          
  #                     #   #       #             
   # #     # #  #    #  #   #     # ## #   #   #  
       #    ##             #                  # # 
 #   #   #              #            ##      #    
# # #                      #                    # 
                   #      ## #            #  ##   
#       ##    #       #            #      ##      
  ##       #   ##      # ## #  #  #       ##   # #
#       #   #             #  # #  #       #  #    
#      #         ##                 #  #      # # 
   # ##         #      #       ####    #  # ##    
          ## # #      # # #  #   #                
                #            #  # #       #  #    
      ##            # #             ##     #    # 
                     #             # #            
         #   #     # #         #    #    ##   # # 
               ##     ##         #        # #     
  #    #      #  #   # #             ##    #      
                          #  #    #     #         
 #       #              #   #  #         #   # #  
             #           #    #         #    #   #
   #    ##   #               #                  # 
             #     #                              
  #   #                  #         #        #     
 ##                       #             #         
 #      #         #                               
 #          #            #  ##     #  # #         
                                                 #
  #      ##     #    #                            
   #  ##      #   #   #  ##                       
#  #       # #        ##  #     # # ##            
   #  #           ##    #      #  # #     # #     
#      ##        #                      #      #  
 #           #          #            #     # #    
       # #                 #            #  #   #  
    #     #         #                ##           
      #     #         #                           
      # #                            #            
 #            #     # #    #              #    #  
              #         #        ##  #            
    #     #######          #                      
    #  # # #        #   #    #       #     #   #  
#           #        #    #  #    #  #       ##   
 #  ##    ##   #     #   # #     #   #         #  
     ##  #        #  #            #     #   #     
             #  #    #           #         #      
      ##          ##     #  #     #      #        
   #           # #  #                             
