      #              #                   #        
   #  #   #        ##     #   #       #   # #  #  
    #          #        #       #     #       #  #
 #              #     #   #        ##  #          
                    ##  #       #     #   ## #  # 
    # ##          #   ##         #            #   
  #      #       #     #    #   #   # #     # #   
         #                  #      #     #        
       #        #        #          #        ## # 
                 ## #    ##         # #           
  #         #     #   #   #   #                 # 
                #     ##      #    #              
#        #               #          #         #   
     #         #  # #  ##                         
#                    # #        ##  #     #  #    
#  #  #      #  #                 ##  #          #
     #  #                ##      #                
                                                  
    #       #      ##               #         #   
  #     #  ####               #                   
#          #                #          #    #    #
    #  #   #   #        # #  #  #   #    #      ##
                   #                              
 #   #          #   #    #          #           ##
      #        #                #                 
                    #     #                       
                                 #                
          #                                #      
          #      #           #             ##    #
                    #                             
# # #                 #       # #  #       #      
  ## # ##                 #     #    ##           
                ####           #   ##       #  ## 
                     #     #  # #  #     #     ## 
          #       #     #               #  ##     
             #    #     #    #      ##           #
             # #  #      #   # #     #           #
                  #          #           #        
  #         #    #  #                             
                                   #  #           
                #        #    # #               # 
       # #  #      #        #    #   #    #   #   
    #    ##            #  #  #  ##  ###           
       #  #              #    #    #       #    # 
     #        #         #               #   ##    
# #         #             #      #   #        #   
  #           # #        #                        
     #      #            #        #   #          #
# #  #                     ##            #   #    
        #     #####       #        # #      #     
