  ##  #             #            #    #  #   #    
##   #       #      #         ##  ##     # #     #
   #    #   #     #    ##    #      #          #  
#   #  #          ##  #        #   #     #   ##   
    #     #  #             # #      ##            
   #   #    #     # #  #   #                      
        #  #    # #            #            ##    
            #                        #       #    
         #            #      ##  #        #   #   
    #  # #    #          #     #   #  #  ##  #    
   #      # #     #   #            #     ##       
     #             #  ##            #     #      #
             ##     #           #        #     #  
         #    # #                    #         #  
  #                   # ###    #         ##       
#    # #   #    #   #       #  #                ##
     #     ## #          #                        
           #  #    #           #      #   #  #    
 #    #         #                ###     ###      
        #  #        #   #            ##           
  # #  ##          #  #          #       ###  #   
            #     #     #        #        ##      
  ##         #           ##         #             
           #     ## #    #  #                     
              #  #                #          #### 
 #                                                
                        #   #   #             #   
                 #           #     #              
         #                  ##        #           
         #           #                           #
#  #   # #  #        #  #   #          #     #    
  #      #     #                     ##   #       
          #      ##                #        # ##  
     #     #     ### #  #     #   #       ##  # # 
            # #             # # #               # 
##    #    #     #              #         #       
           #   #      #        # #     #          
                #                         #       
  # # #   # #       #    #   #   #       #        
# #      # #   #          #          #  #         
         # #  ##     ##    #            #       ##
    # #     # #    ##       #   #                 
  # #                #  #         #      #    #   
 # #  ###            # #              #           
  #   ## #      #         #        #   #      # # 
      #     #             #   #         #    #    
#   #              # #        #       #           
  # #   # # #            #            #           
##         #                 ##  #      ##        
  #        # #       #                  ##        
