 # # #     # #        #               #    #      
                         #    #       ##          
  #     # ##   #  #   #      ####           ##  # 
          #  #                       #   #       #
    #        #  ##   #                      #   # 
##                         #       ### #          
   #          ###  #     #      #     #        #  
          # ##                       # #     #    
     #  #      #            #   ## #         # #  
 # #                     #    ##         #       #
           #  # #              #                  
 # #  ##  # #   # #               #   #         # 
    #     #                 ##   #   ##      ##   
      #     #     #     #                #  #    #
      #  #              # # #         #          #
  #        #      #         #   ## #      #    #  
           #                 #   #   #          # 
    ##                   #  ###           ##     #
          #     #         #       #          #    
##     #          #              #  #             
     #                 #             #        #   
  #            #                 ##          #   #
         #  # #       ##          #      #   #    
 #     #            #          #       ## #  #    
      #    #        #         #   ##           ## 
                                                  
            #     #  #                  #         
             #   #        #   #                   
     #       #              #        #       # #  
                      #                           
  #              ## #    #      #       #   #     
        #  #        #        #        #           
        #                            #     #     #
     #          #              #   #      #     # 
     ##              #        ###        #        
#                        #    # #  #              
         ##   #        #            ##   #   # #  
            #     #       #   #   # # #       #   
         #       #    #          #      #    ##   
     #  #           ##      #  #  #         #     
       #                 #      #    #            
    #          ## #  #    ##           #  #   #   
  #                  #        #   ##              
  #             #             #   #  #      #     
##   #   #  #             #     #      # #      # 
   #            #           #                  # #
#          #  ## # #               #    #         
 ##   #    #   # #                       ####     
         #  #               # #  #     #    #  #  
    #            # #       #   #              #   
