 #     #   #          #  #        #  # #          
                   #   #        #   #        #  # 
 #          ##   #                #  #   #        
#       #  #  #  ##      ##    ##   #        #   #
              #       #  #   #   #       #     #  
          #    #      #    #   #   #              
  ##  #     #      #     # ## ##  #          # #  
 #      #  #         #   #      #                 
  #   # # #                ## #       #   #       
#      #       #           #  #  # # #      #     
  #       #          #               #        #   
  ####      #          #        #               # 
    #  #  #   # #    # #           # #            
#   #      ###           #             #    ##    
    #        #  #         #              ##  # #  
        #  ##   # #      #       #        #       
  #  #        #           #    #                  
  #    #             # #                      # # 
        #                    ###       #   ##     
       #         #        #       #    #    #     
                         #        #        #    # 
#        ##   #      # # #       #   ##   ##      
  # #            #         ##          #          
     #    #    #        # #    #       ## #  #   #
      #   #                 #      #  #        # #
#    #    #              #    #                   
 ##     #                             #     #     
        # #          #        # #                #
    # #  #           #                  #         
 #                  #                      #      
  #                #         ## # #     #         
 #       #         ###   ##       ##       #      
  #          #   #        #   #      #    # ##    
 # # #         #  #                 #     #    # #
          #               ##     #                
                 #  ####  ##                  #   
##    # #  # #  #  #                          # # 
  #     #  ##     #      #     ###      ##  #     
   #  #      #             # #                    
  # #            #   #                 #        # 
        #    ####         #            ##         
    # #    #       ##     ##          #         # 
        #     # #      # # #            ###   #   
   #           #  #    ##      ## #      # #    # 
#     ##   # #   #           #    #              #
#             #  #                #   # #   #     
     #          #    #           #   #   #   #    
#         #                  ##     # #     #  #  
     ##  #       #              #       # #       
#      #          #                          #    
