#      #       ####     #             ##          
#   #       #  ## # #        # #           # #    
      #   ##    #                   #             
    # ##     # # ###  #   #  # # #       #        
#                          ##        ##  #        
#   #                       #         #       #   
     #      #         ##            ##  #         
       #          ### #   #   ##       #          
             #            #        #  # ##        
##        ##   #   #      ## #             #      
#    #              ##             #      #    #  
 # ##   #   #     #  ##  #           # #    # #   
    #                 #      #           ## ##    
        #                       # #               
       # #         #               #     ##   #  #
#    #             #   #   #     #        ##  # # 
     #    ###   #                        #    ### 
          ##         #   #   #         #          
        #          #              #        #      
         #   #           #         #             #
#  #         #     #              #  #     #      
     ##       #  #    ##     #   ##  #            
#      ###      # #  #   #          # #        #  
                        #      ##   ##  #         
             #            #                       
                          #                      #
                        #          #  #        #  
 #  ##                  ###          #            
 #       #                  #               #     
                          #                       
                      #     # # #       #       # 
                ##              #  #              
# #   #  #  #              #  #    # #   #        
  # #     #   # ##        #                       
   # ##        #     #            #       #       
##            #    #               #   #     #    
  #      #     #    #           ##  # ##         #
       #            #  #         #             #  
# #     #  # # ##           #              ## ##  
       #  # #   #    #               # #         #
         #                                       #
 #                #        #    #    #     #   #  
   #  ##           #                     #        
   #  #              #                       #    
                           #   #  #   #      #    
   #          #    #      #    #    #  # #      # 
##         #   #    #         # ##  #            #
    #         # ##       #   ##                   
    ##     #    #                   #    # # #### 
       ##                           #   ##    # # 
