      #       #   #  # ##       #      #  #       
   #         ###     #                            
   # #        #   #   ### #   #      #    #    #  
      #      #  ##     #  #    #  # #            #
 #        #     #           ####                  
 #    #     #  ##               #            #    
                #    #     #         #        #   
 #    # #      # #     #  #       #         #  #  
   #   ##             # #           #        # #  
      #         #            #       #        #   
  #       #                         #  # #        
     # #     ##  #        #                       
     #           # # #        #   #        #      
#    #                        #   ##  #           
    #  #          #        # #             ##     
#    #          #               #     #    ### #  
  #   #       #       #     #      #         #   #
  #                             ##  #  #          
   ##         # #      #                 #      # 
   #        #   #                 #  ##   #  #    
#            #  #   #   ##  #  # #         # #    
     #      #       #   #                     #  #
             #   #                      #   ##    
     #    #   #          #  #    #  #         ##  
            #  #            #                    #
                      # ##                #       
      #                   # #        #  #   # # # 
    ##           #       ## #      #  #    #      
                 #  #     #   # #                 
     #         #                                  
    # #      #      #    #    #   # #  #    # #   
   # ##   #     #       # #                 # # ##
  #    #  #                 ###   #  #  #     # ##
   #           #  #        #                    # 
                    #     #      #     #    #     
    #  #     # #  #    #    #      #        #    #
     ##       #  #              #           #     
          # #        # #     #               #    
        #        # #  ##  #           #     #   # 
 #         # #        #                       #   
               # # #  #         ## ##          #  
 #                  # # #   #   #     # #   #     
 #       ## #       #    ##        #  #    #     #
       #  #    #     # #   #          #   # #  #  
    ###  ##            #                      #  #
     #      #                  #        #    #    
     #    # #  #   ##   #     #        #          
 #   #         #          ##             #        
       #  #                     #    #            
  #                         # # #  #  ##          
