      #  #    ##                   #  #           
    #          # #       #    #          # # ##   
  #                  #          ###        #  #   
#   ##        #    ## #   #                 #     
   #                #     #          #            
                 # #          #               # # 
        ##   ##            #      #               
   #   # #  #         ## #    ##             # #  
# ##                 # #       #                  
  #                                               
     #   #          #         #    #              
              #        #                          
         # #              #       #       #       
            #                    #  #      # #    
   ##              ##   #      #  #    # #        
         #     #      ##           ##             
      #         ##  #          # #       #      # 
     #           #          ##  #                 
  #     #      #    #    #        #     # #       
     #                    #         #         #   
    #           ##   #   #          #   ## #  #   
          #     #       #  #   #                  
               #  #     #             #  #  #     
                      #           #     #         
         # #                 #  #                 
#   #     #                        #              
                          #                      #
##               #      #     #            #      
        #                     #           #       
  #      #                #                       
                # #                     #         
#            ##  #  # ##  # #                     
      #   #   ##  #       #            #         #
          #      #     #  #  #        # ##        
  #       # ##           # #         #     #   #  
    #  ##          # #               #         #  
 #  #    # #    # #          #    ## #   #  #  #  
        #         # #      #          #  # #      
         #   #  #   #         #   #  #    #       
             #  #          #    ##  #      #   # #
   #  #   #     #        #   # ##          #    # 
                                         #     #  
  #    #       #    #   #   # #          #  #     
      #                 #        ### # #  #       
                #     ##     #         #   #      
                   #      #    # #    #     ## #  
 #  #               # #        #   #   #          
                  #                  #          # 
          ##    #                     #          #
  #     ##   #     # ## #     #            #      
